0 0 0 0 0 0 0 0 0 0 0 0 0 0 0 0
0 0 0 0 0 0 0 0 0 0 0 0 0 0 0 0
0 0 3 3 3 3 3 3 3 3 3 3 3 3 0 0
0 0 3 3 3 3 3 3 3 3 3 3 3 3 0 0
0 0 3 3 3 3 3 3 3 3 3 3 3 3 0 0
0 0 3 3 3 3 3 3 3 3 3 3 3 3 0 0
0 0 3 3 3 3 3 3 3 3 3 3 3 3 0 0
0 0 3 3 3 3 3 3 3 3 3 3 3 3 1 1
0 0 3 3 3 3 3 3 3 3 3 3 5 3 1 1
0 0 4 3 3 22 3 3 3 3 3 3 3 3 0 0
0 0 4 3 21 3 3 3 3 3 3 3 3 3 0 0
0 0 4 3 3 3 3 25 3 3 3 3 3 3 0 0
0 0 4 3 3 3 3 3 3 4 4 4 4 4 0 0
0 0 4 4 4 4 4 4 4 4 4 4 4 4 0 0
0 0 0 0 0 0 0 1 1 0 0 0 0 0 0 0
0 0 0 0 0 0 0 1 1 0 0 0 0 0 0 0

0 0 0 0 0 0 0 1 1 0 0 0 0 0 0 0
0 0 0 0 0 0 0 1 1 0 0 0 0 0 0 0
0 0 3 3 3 3 3 4 4 4 4 4 4 4 0 0
0 0 3 3 3 3 3 4 4 4 4 4 4 4 0 0
0 0 3 3 3 3 3 4 4 4 4 4 4 4 0 0
0 0 3 3 3 3 3 4 4 4 4 4 4 4 0 0
0 0 3 3 3 3 3 4 4 4 4 4 4 4 0 0
1 1 3 3 3 5 3 4 4 4 4 4 4 4 0 0
1 1 3 3 3 3 3 4 4 4 4 4 4 4 0 0
0 0 3 3 3 3 3 3 3 3 3 4 4 4 0 0
0 0 3 3 3 3 3 3 3 8 3 4 4 4 0 0
0 0 3 3 3 3 3 3 3 3 3 4 4 4 0 0
0 0 3 3 3 3 3 2 2 3 3 4 4 4 0 0
0 0 3 3 3 3 3 2 2 3 3 4 4 4 0 0
0 0 0 0 0 0 0 0 0 0 0 0 0 0 0 0
0 0 0 0 0 0 0 0 0 0 0 0 0 0 0 0

0 0 0 0 0 0 0 0 0 0 0 0 0 0 0 0
0 0 0 0 0 0 0 0 0 0 0 0 0 0 0 0
0 0 4 3 3 3 4 2 2 4 4 4 4 4 0 0
0 0 4 3 3 3 4 2 2 4 4 4 4 4 0 0
0 0 4 3 3 3 4 4 4 4 4 4 4 4 0 0
0 0 4 3 3 3 4 4 4 4 4 4 4 4 0 0
0 0 4 3 3 3 4 4 4 4 4 4 4 4 0 0
1 1 4 3 3 3 4 4 4 4 4 4 4 4 0 0
1 1 4 3 5 3 4 4 4 4 4 4 4 4 0 0
0 0 4 3 3 3 4 4 4 4 4 4 4 4 0 0
0 0 4 3 3 3 4 4 4 4 4 4 4 4 0 0
0 0 4 3 3 3 4 4 4 4 4 4 4 4 0 0 
0 0 4 3 3 3 4 2 2 4 4 4 4 4 0 0
0 0 4 3 3 3 4 2 2 4 4 4 4 4 0 0
0 0 0 0 0 0 0 0 0 0 0 0 0 0 0 0
0 0 0 0 0 0 0 0 0 0 0 0 0 0 0 0

0 0 0 0 0 0 0 0 0 0 0 0 0 0 0 0
0 0 0 0 0 0 0 0 0 0 0 0 0 0 0 0
0 0 3 3 3 3 3 2 2 3 3 3 3 3 0 0
0 0 3 3 3 3 3 2 2 3 3 3 3 3 0 0
0 0 3 3 3 3 3 3 3 3 3 3 3 3 0 0
0 0 3 3 3 3 3 3 3 3 3 3 3 3 0 0
0 0 3 3 3 3 3 3 3 3 3 3 3 3 0 0
0 0 2 2 3 3 3 3 3 3 3 3 3 7 0 0
0 0 2 2 3 3 3 3 3 3 3 3 4 4 0 0
0 0 3 3 3 3 3 3 3 3 3 3 4 4 0 0
0 0 3 3 3 3 3 3 3 3 3 3 3 3 0 0
0 0 4 4 4 3 3 4 4 4 4 3 3 3 0 0
0 0 4 4 4 3 3 4 4 4 4 3 3 3 0 0
0 0 4 4 4 9 9 4 4 4 4 9 9 9 0 0
0 0 0 0 0 0 0 0 0 0 0 0 0 0 0 0
0 0 0 0 0 0 0 0 0 0 0 0 0 0 0 0
