0 0 0 0 0 0 0 0 0 0 0 0 0 0 0 0
0 0 0 0 0 0 0 0 0 0 0 0 0 0 0 0
0 0 3 3 3 3 3 2 2 3 3 3 3 3 0 0
0 0 3 3 3 3 3 2 2 3 3 3 3 3 0 0
0 0 3 3 3 3 3 3 3 3 3 3 3 3 0 0
0 0 3 3 3 3 3 5 3 3 3 3 3 3 0 0
0 0 3 3 25 3 3 3 3 3 3 3 3 3 0 0
0 0 3 3 3 3 3 3 3 3 3 3 2 2 0 0
0 0 4 4 4 4 4 4 4 3 3 3 2 2 0 0
0 0 4 3 3 3 3 3 3 3 3 3 3 3 0 0
0 0 4 3 7 3 12 12 12 3 3 3 3 3 0 0
0 0 4 3 3 3 3 3 3 3 3 3 3 3 0 0
0 0 4 4 4 4 4 4 4 4 4 4 4 4 0 0
0 0 4 4 4 4 4 4 4 4 4 4 4 4 0 0
0 0 0 0 0 0 0 0 0 0 0 0 0 0 0 0
0 0 0 0 0 0 0 0 0 0 0 0 0 0 0 0

0 0 0 0 0 0 0 1 1 0 0 0 0 0 0 0
0 0 0 0 0 0 0 1 1 0 0 0 0 0 0 0
0 0 3 3 3 3 3 3 3 3 3 3 3 3 0 0
0 0 3 3 3 3 3 3 3 3 3 3 3 3 0 0
0 0 3 3 3 3 3 3 3 3 3 3 3 3 0 0
0 0 4 4 4 3 3 3 3 3 3 3 3 3 0 0
0 0 4 4 4 3 3 5 3 3 3 3 3 3 0 0
0 0 2 2 4 3 3 3 3 3 3 3 2 2 0 0
0 0 2 2 4 3 3 3 3 3 3 3 2 2 0 0
0 0 4 4 4 4 4 4 3 3 3 3 9 4 0 0
0 0 4 4 4 4 4 4 3 11 3 3 9 4 0 0
0 0 4 4 4 4 4 4 3 3 3 3 9 4 0 0
0 0 4 4 4 4 4 4 9 9 9 9 4 4 0 0
0 0 4 4 4 4 4 4 4 4 4 4 4 4 0 0
0 0 0 0 0 0 0 0 0 0 0 0 0 0 0 0
0 0 0 0 0 0 0 0 0 0 0 0 0 0 0 0

0 0 0 0 0 0 0 1 1 0 0 0 0 0 0 0
0 0 0 0 0 0 0 1 1 0 0 0 0 0 0 0
0 0 10 10 10 4 4 10 10 4 4 4 4 4 0 0
0 0 3 3 3 4 4 3 3 4 4 9 9 9 0 0
0 0 3 3 3 4 4 3 3 4 4 3 3 3 0 0
0 0 3 3 3 4 4 3 3 4 4 3 5 3 0 0
0 0 3 3 3 3 3 3 3 3 3 3 3 3 0 0
0 0 3 3 3 3 3 3 3 3 3 3 3 3 0 0
0 0 3 3 3 3 3 3 3 3 3 3 3 3 0 0
0 0 3 3 3 3 3 3 3 3 3 3 3 3 0 0
0 0 3 3 3 4 4 3 3 4 4 3 3 3 0 0
0 0 3 3 3 4 4 3 3 4 4 3 3 3 0 0
0 0 9 9 9 4 4 3 3 4 4 3 3 3 0 0
0 0 4 4 4 4 4 10 10 4 4 10 10 10 0 0
0 0 0 0 0 0 0 1 1 0 0 0 0 0 0 0
0 0 0 0 0 0 0 1 1 0 0 0 0 0 0 0

0 0 0 0 0 0 0 0 0 0 0 0 0 0 0 0
0 0 0 0 0 0 0 0 0 0 0 0 0 0 0 0
0 0 4 4 4 4 4 4 4 4 4 4 4 4 0 0
0 0 4 4 4 4 4 4 4 4 4 4 4 4 0 0
0 0 4 3 3 3 3 3 13 3 3 3 3 3 0 0
0 0 4 5 3 14 3 3 3 3 3 3 3 3 0 0
0 0 4 3 3 3 3 3 3 3 3 3 3 3 0 0
0 0 4 4 4 4 3 3 3 3 3 3 3 3 1 1
0 0 3 3 3 3 3 3 3 3 3 4 4 4 1 1
0 0 3 11 3 3 3 3 3 3 3 4 4 4 0 0
0 0 3 3 3 3 3 3 3 3 3 3 3 3 0 0
0 0 3 3 3 4 3 3 3 3 3 3 21 3 0 0
0 0 3 3 3 4 3 2 2 3 3 3 3 3 0 0
0 0 3 3 3 4 3 2 2 3 3 3 3 3 0 0
0 0 0 0 0 0 0 0 0 0 0 0 0 0 0 0
0 0 0 0 0 0 0 0 0 0 0 0 0 0 0 0

0 0 0 0 0 0 0 0 0 0 0 0 0 0 0 0
0 0 0 0 0 0 0 0 0 0 0 0 0 0 0 0
0 0 3 3 3 3 3 2 2 3 3 3 3 3 0 0
0 0 3 3 3 3 3 2 2 3 3 3 3 3 0 0
0 0 3 3 3 3 3 3 3 3 3 3 3 3 0 0
0 0 3 3 3 3 3 3 3 3 3 3 3 3 0 0
0 0 3 3 3 3 3 3 3 3 3 3 3 3 0 0
1 1 3 3 3 3 3 3 3 3 4 4 4 4 0 0
1 1 3 3 3 3 3 3 3 3 3 3 3 4 0 0
0 0 3 5 3 3 3 3 3 3 14 3 11 4 0 0
0 0 3 3 3 3 21 3 3 3 3 3 3 4 0 0
0 0 4 4 3 4 4 4 3 4 4 4 4 4 0 0
0 0 4 4 3 4 4 2 2 4 4 4 4 4 0 0
0 0 4 4 3 4 4 2 2 4 4 4 4 4 0 0
0 0 0 0 0 0 0 0 0 0 0 0 0 0 0 0
0 0 0 0 0 0 0 0 0 0 0 0 0 0 0 0

0 0 0 0 0 0 0 1 1 0 0 0 0 0 0 0
0 0 0 0 0 0 0 1 1 0 0 0 0 0 0 0
0 0 4 4 4 4 4 9 4 4 4 9 4 4 0 0
0 0 4 4 4 4 4 13 4 4 4 3 4 4 0 0
0 0 3 3 3 3 3 3 3 3 3 3 3 3 0 0
0 0 4 4 4 4 4 3 4 4 4 3 4 4 0 0
0 0 4 4 4 4 4 3 4 4 4 3 4 4 0 0
1 1 4 4 4 4 4 3 4 4 4 3 4 4 1 1
1 1 3 3 3 3 3 3 3 3 3 11 3 3 1 1
0 0 4 4 4 4 4 3 4 4 4 3 4 4 0 0
0 0 4 4 4 4 4 3 4 4 4 3 4 4 0 0
0 0 4 4 4 4 4 3 4 4 4 3 4 4 0 0
0 0 4 4 4 4 4 3 4 4 4 3 4 4 0 0
0 0 4 4 4 4 4 3 4 4 4 3 4 4 0 0
0 0 0 0 0 0 0 1 1 0 0 0 0 0 0 0
0 0 0 0 0 0 0 1 1 0 0 0 0 0 0 0