0 0 0 0 0 0 0 0 0 0 0 0 0 0 0 0
0 0 0 0 0 0 0 0 0 0 0 0 0 0 0 0
0 0 3 3 3 3 3 2 2 3 3 3 3 3 0 0
0 0 3 3 17 3 3 2 2 5 3 17 3 3 0 0
0 0 3 3 3 3 3 3 3 3 3 3 3 3 0 0
0 0 3 3 3 3 4 4 4 4 3 3 3 3 0 0
0 0 8 3 3 3 3 3 3 3 3 3 3 8 0 0
1 1 3 3 3 3 3 3 3 3 3 3 3 3 1 1
1 1 4 16 16 3 3 3 3 3 3 16 16 4 1 1
0 0 3 3 3 3 3 3 3 3 3 3 3 3 0 0
0 0 3 25 20 3 3 3 3 3 3 3 3 3 0 0
0 0 3 3 3 3 3 3 3 3 3 3 3 3 0 0
0 0 4 4 4 8 3 2 2 3 8 4 4 4 0 0
0 0 4 4 4 4 3 2 2 3 4 4 4 4 0 0
0 0 0 0 0 0 0 0 0 0 0 0 0 0 0 0
0 0 0 0 0 0 0 0 0 0 0 0 0 0 0 0

0 0 0 0 0 0 0 1 1 0 0 0 0 0 0 0
0 0 0 0 0 0 0 1 1 0 0 0 0 0 0 0
0 0 4 4 4 4 3 3 3 3 4 4 4 4 0 0
0 0 4 4 4 4 17 17 17 17 4 4 4 4 0 0
0 0 4 4 4 4 18 18 18 18 4 4 4 4 0 0
0 0 4 4 4 4 3 3 3 3 4 4 4 4 0 0
0 0 4 4 4 3 3 3 3 3 3 4 4 4 0 0
0 0 2 2 3 3 3 3 3 3 3 3 2 2 0 0
0 0 2 2 3 3 3 3 3 3 3 3 2 2 0 0
0 0 3 3 3 3 3 3 3 3 3 3 3 3 0 0
0 0 3 3 3 3 3 5 3 3 3 3 3 3 0 0
0 0 3 3 3 3 3 3 3 3 3 20 3 3 0 0
0 0 3 3 3 3 3 3 3 3 3 3 3 3 0 0
0 0 4 4 4 4 4 4 4 4 4 4 4 4 0 0
0 0 0 0 0 0 0 0 0 0 0 0 0 0 0 0
0 0 0 0 0 0 0 0 0 0 0 0 0 0 0 0

0 0 0 0 0 0 0 1 1 0 0 0 0 0 0 0
0 0 0 0 0 0 0 1 1 0 0 0 0 0 0 0
0 0 4 4 4 4 4 4 4 4 3 3 3 4 0 0
0 0 4 4 4 3 3 11 3 4 3 3 3 4 0 0
0 0 4 4 4 3 3 3 3 4 3 3 3 4 0 0
0 0 4 4 4 3 3 3 3 3 3 3 3 4 0 0
0 0 4 4 4 3 3 17 3 3 3 3 4 4 0 0
1 1 17 12 3 4 3 3 3 3 4 4 4 4 0 0
1 1 17 3 5 4 3 3 3 3 3 4 4 4 0 0
0 0 17 3 3 4 3 3 3 3 3 3 4 4 0 0
0 0 4 4 4 4 4 3 3 3 3 3 3 4 0 0
0 0 4 4 4 4 4 3 3 3 3 3 3 4 0 0
0 0 4 4 4 4 4 3 3 3 3 3 3 4 0 0
0 0 4 4 4 4 4 3 3 3 3 3 3 4 0 0
0 0 0 0 0 0 0 1 1 0 0 0 0 0 0 0
0 0 0 0 0 0 0 1 1 0 0 0 0 0 0 0

0 0 0 0 0 0 0 0 0 0 0 0 0 0 0 0
0 0 0 0 0 0 0 0 0 0 0 0 0 0 0 0
0 0 4 4 4 4 4 4 4 4 4 4 4 4 0 0
0 0 4 4 4 9 9 9 9 9 4 4 4 4 0 0
0 0 3 3 3 3 3 3 3 3 4 4 4 4 0 0
0 0 3 3 3 3 3 3 3 3 3 3 3 3 0 0
0 0 3 3 3 3 3 3 3 3 3 3 3 3 0 0
1 1 3 3 3 3 3 3 3 3 3 3 3 3 0 0
1 1 4 3 3 3 3 3 3 3 3 3 3 3 0 0
0 0 4 3 3 3 3 3 3 3 3 5 3 3 0 0
0 0 4 3 3 3 3 17 3 3 3 3 3 3 0 0
0 0 4 3 3 3 4 3 4 3 3 3 3 3 0 0
0 0 4 3 3 3 4 8 4 3 3 3 3 3 0 0
0 0 4 3 3 3 4 4 4 3 3 3 3 3 0 0
0 0 0 0 0 0 0 1 1 0 0 0 0 0 0 0
0 0 0 0 0 0 0 1 1 0 0 0 0 0 0 0

0 0 0 0 0 0 0 0 0 0 0 0 0 0 0 0
0 0 0 0 0 0 0 0 0 0 0 0 0 0 0 0
0 0 3 3 3 3 3 2 2 3 3 3 3 3 0 0
0 0 3 3 3 3 3 2 2 3 3 3 3 3 0 0
0 0 3 3 4 4 4 4 4 4 4 4 4 4 0 0
0 0 3 3 4 3 8 3 4 3 3 3 3 3 0 0
0 0 3 3 4 3 3 3 4 3 3 3 3 3 0 0
0 0 2 2 4 17 17 17 4 3 3 3 5 3 0 0
0 0 2 2 3 3 3 3 3 3 3 3 3 3 0 0
0 0 3 3 3 3 3 3 3 3 3 3 4 4 0 0
0 0 3 3 3 3 3 3 3 3 3 3 3 3 0 0
0 0 3 3 3 3 3 3 3 3 3 3 3 23 0 0
0 0 4 4 4 4 4 4 4 4 4 4 4 3 0 0
0 0 4 4 4 4 4 4 4 4 4 4 4 4 0 0
0 0 0 0 0 0 0 0 0 0 0 0 0 0 0 0
0 0 0 0 0 0 0 0 0 0 0 0 0 0 0 0

0 0 0 0 0 0 0 1 1 0 0 0 0 0 0 0
0 0 0 0 0 0 0 1 1 0 0 0 0 0 0 0
0 0 4 4 4 4 4 4 4 3 3 3 4 4 0 0
0 0 4 4 4 4 4 4 4 3 3 3 4 4 0 0
0 0 4 9 3 3 3 3 17 3 3 3 4 4 0 0
0 0 4 9 3 5 3 3 17 3 3 3 4 4 0 0
0 0 4 9 3 3 3 3 17 3 3 3 4 4 0 0
1 1 4 4 17 17 17 4 4 3 3 3 4 4 1 1
1 1 4 4 3 3 3 4 4 3 3 3 4 4 1 1
0 0 4 4 3 3 3 4 4 3 3 3 3 3 0 0
0 0 4 4 3 3 3 4 4 3 3 3 3 3 0 0
0 0 4 4 3 3 3 4 4 3 3 3 3 3 0 0
0 0 4 4 3 3 3 4 4 4 4 4 4 4 0 0
0 0 4 4 3 3 3 4 4 4 4 4 4 4 0 0
0 0 0 0 0 0 0 1 1 0 0 0 0 0 0 0
0 0 0 0 0 0 0 1 1 0 0 0 0 0 0 0