0 0 0 0 0 0 0 0 0 0 0 0 0 0 0 0
0 0 0 0 0 0 0 0 0 0 0 0 0 0 0 0
0 0 3 3 3 3 3 3 3 3 3 3 3 3 0 0
0 0 3 3 3 3 3 3 3 3 3 3 3 3 0 0
0 0 3 3 3 3 3 3 3 3 3 3 3 3 0 0
0 0 3 3 3 3 3 3 3 3 3 3 3 3 0 0
0 0 3 3 3 3 3 3 3 3 3 3 3 3 0 0
0 0 3 3 3 3 3 3 3 3 3 3 2 2 0 0
0 0 3 3 3 3 3 3 3 3 3 3 2 2 0 0
0 0 3 3 3 3 3 3 3 3 4 4 4 4 0 0
0 0 3 3 3 3 3 3 3 3 14 3 3 3 0 0
0 0 3 3 3 25 3 3 3 3 3 3 5 3 0 0
0 0 3 13 3 3 3 21 3 3 3 3 3 3 0 0
0 0 4 4 4 4 4 4 4 4 4 4 4 4 0 0
0 0 0 0 0 0 0 0 0 0 0 0 0 0 0 0
0 0 0 0 0 0 0 0 0 0 0 0 0 0 0 0

0 0 0 0 0 0 0 1 1 0 0 0 0 0 0 0
0 0 0 0 0 0 0 1 1 0 0 0 0 0 0 0
0 0 4 3 3 3 3 3 3 3 3 3 3 3 0 0
0 0 4 13 3 3 3 3 3 3 3 3 3 3 0 0
0 0 4 3 3 3 3 3 3 3 3 3 3 3 0 0
0 0 4 4 4 3 3 3 3 3 3 3 3 3 0 0
0 0 4 4 4 4 4 3 3 3 3 3 3 3 0 0
0 0 4 4 4 4 4 3 21 3 3 3 3 3 1 1
0 0 4 4 4 4 4 3 20 3 3 3 3 3 1 1
0 0 4 4 4 4 4 3 3 3 3 3 3 3 0 0
0 0 4 3 3 3 14 3 3 3 3 3 3 3 0 0
0 0 4 3 5 3 3 3 3 3 3 3 3 3 0 0
0 0 4 3 3 3 3 3 3 3 3 3 3 3 0 0
0 0 4 3 3 3 4 4 4 4 4 4 4 4 0 0
0 0 0 0 0 0 0 1 1 0 0 0 0 0 0 0
0 0 0 0 0 0 0 1 1 0 0 0 0 0 0 0

0 0 0 0 0 0 0 0 0 0 0 0 0 0 0 0
0 0 0 0 0 0 0 0 0 0 0 0 0 0 0 0
0 0 3 3 3 3 3 3 3 3 3 3 3 3 0 0
0 0 3 3 3 3 3 3 3 3 3 3 3 3 0 0
0 0 3 3 3 3 3 3 3 3 3 3 3 3 0 0
0 0 3 3 3 3 3 3 3 3 3 3 3 3 0 0
0 0 3 3 3 3 3 3 3 3 3 3 3 3 0 0
0 0 2 2 3 3 3 3 3 3 3 3 3 3 0 0
0 0 2 2 3 3 3 3 3 3 3 3 3 3 0 0
0 0 3 3 3 3 3 3 3 3 4 4 4 4 0 0
0 0 3 20 3 3 3 3 3 3 14 3 3 3 0 0
0 0 3 3 3 3 3 3 3 3 3 3 5 3 0 0
0 0 3 13 3 3 3 3 3 3 3 3 3 3 0 0
0 0 4 4 4 3 3 3 4 4 4 4 4 4 0 0
0 0 0 0 0 0 0 1 1 0 0 0 0 0 0 0
0 0 0 0 0 0 0 1 1 0 0 0 0 0 0 0

0 0 0 0 0 0 0 1 1 0 0 0 0 0 0 0
0 0 0 0 0 0 0 1 1 0 0 0 0 0 0 0
0 0 4 4 4 4 4 4 3 3 3 3 3 3 0 0
0 0 4 4 4 4 4 4 13 3 3 3 3 3 0 0
0 0 4 4 4 4 4 4 3 3 3 3 3 3 0 0
0 0 4 4 4 4 4 4 4 4 3 3 3 3 0 0
0 0 4 4 4 4 4 4 4 4 3 3 3 3 0 0
0 0 4 4 4 4 4 4 4 4 3 3 2 2 0 0
0 0 4 4 4 4 4 4 4 4 3 3 2 2 0 0
0 0 4 4 4 4 4 4 4 4 3 3 3 3 0 0
0 0 4 4 4 4 4 4 3 14 3 3 3 3 0 0
0 0 4 4 4 4 4 3 3 3 3 3 3 3 0 0
0 0 4 4 4 4 4 7 3 3 3 3 3 3 0 0
0 0 4 4 4 4 4 4 4 4 3 3 3 3 0 0
0 0 0 0 0 0 0 0 0 0 0 0 0 0 0 0
0 0 0 0 0 0 0 0 0 0 0 0 0 0 0 0