0 0 0 0 0 0 0 0 0 0 0 0 0 0 0 0
0 0 0 0 0 0 0 0 0 0 0 0 0 0 0 0
0 0 3 3 3 3 3 3 3 3 3 3 3 3 0 0
0 0 3 3 3 3 3 3 3 3 3 3 3 3 0 0
0 0 3 3 3 3 3 3 3 3 3 3 3 3 0 0
0 0 3 3 3 3 3 3 3 3 3 3 3 3 0 0
0 0 3 3 3 3 3 3 3 3 3 3 5 3 0 0
1 1 3 3 3 3 16 16 3 3 3 3 3 3 1 1
1 1 16 16 16 3 3 3 3 3 3 3 4 4 1 1
0 0 3 3 3 3 3 3 3 3 3 3 3 3 0 0
0 0 20 25 3 4 3 3 3 3 3 3 3 23 0 0
0 0 3 3 3 4 3 3 3 3 3 3 3 3 0 0
0 0 4 4 4 4 4 4 4 4 4 4 4 4 0 0
0 0 4 4 4 4 4 4 4 4 4 4 4 4 0 0
0 0 0 0 0 0 0 0 0 0 0 0 0 0 0 0
0 0 0 0 0 0 0 0 0 0 0 0 0 0 0 0

0 0 0 0 0 0 0 0 0 0 0 0 0 0 0 0
0 0 0 0 0 0 0 0 0 0 0 0 0 0 0 0
0 0 3 3 3 3 3 3 3 3 3 3 3 3 0 0
0 0 3 3 3 3 3 3 3 3 3 3 3 3 0 0
0 0 3 3 3 3 3 3 3 3 3 3 5 3 0 0
0 0 3 3 3 3 3 3 3 3 3 3 3 3 0 0
0 0 3 3 3 3 3 3 3 3 3 3 4 4 0 0
0 0 2 2 3 3 3 3 3 3 3 4 2 2 0 0
0 0 2 2 3 3 3 3 3 3 4 4 2 2 0 0
0 0 3 3 3 3 3 3 3 3 3 3 3 4 0 0
0 0 3 20 3 3 3 3 8 3 3 3 23 4 0 0
0 0 3 3 4 4 4 4 4 4 4 4 3 4 0 0
0 0 4 4 4 4 4 4 4 4 4 4 4 4 0 0
0 0 4 4 4 4 4 4 4 4 4 4 4 4 0 0
0 0 0 0 0 0 0 0 0 0 0 0 0 0 0 0
0 0 0 0 0 0 0 0 0 0 0 0 0 0 0 0

0 0 0 0 0 0 0 0 0 0 0 0 0 0 0 0
0 0 0 0 0 0 0 0 0 0 0 0 0 0 0 0
0 0 4 4 3 3 3 2 2 3 3 3 3 3 0 0
0 0 3 3 3 3 3 2 2 3 3 3 3 3 0 0
0 0 3 3 3 3 3 3 3 3 3 3 3 3 0 0
0 0 3 20 3 3 3 3 3 3 3 3 3 3 0 0
0 0 3 3 3 3 3 3 3 3 3 3 3 3 0 0
1 1 30 3 3 3 4 4 3 3 3 3 2 2 0 0
1 1 4 4 3 3 3 3 3 3 4 4 2 2 0 0
0 0 4 4 3 3 3 3 3 3 3 3 3 3 0 0
0 0 4 4 4 3 3 3 5 3 23 3 20 3 0 0
0 0 4 4 4 4 3 3 3 3 3 3 3 3 0 0
0 0 4 4 4 4 4 4 4 4 4 4 4 4 0 0
0 0 4 4 4 4 4 4 4 4 4 4 4 4 0 0
0 0 0 0 0 0 0 0 0 0 0 0 0 0 0 0
0 0 0 0 0 0 0 0 0 0 0 0 0 0 0 0

0 0 0 0 0 0 0 1 1 0 0 0 0 0 0 0
0 0 0 0 0 0 0 1 1 0 0 0 0 0 0 0
0 0 4 4 3 3 3 3 3 3 3 3 3 3 0 0
0 0 4 4 3 3 3 3 3 3 3 3 3 3 0 0
0 0 4 4 3 3 3 3 3 3 3 3 3 3 0 0
0 0 4 4 3 3 3 3 3 3 3 3 3 3 0 0
0 0 4 4 3 3 3 3 3 3 3 3 3 3 0 0
1 1 4 4 3 3 3 3 3 3 3 3 3 3 0 0
1 1 3 16 3 3 3 3 3 3 3 3 3 3 0 0
0 0 3 16 3 3 3 3 3 3 3 3 3 3 0 0
0 0 3 16 3 3 3 3 23 3 20 3 3 3 0 0
0 0 4 4 3 5 3 3 3 3 3 3 3 3 0 0
0 0 4 4 3 3 3 4 4 4 4 4 4 4 0 0
0 0 4 4 4 4 4 4 4 4 4 4 4 4 0 0
0 0 0 0 0 0 0 0 0 0 0 0 0 0 0 0
0 0 0 0 0 0 0 0 0 0 0 0 0 0 0 0

0 0 0 0 0 0 0 0 0 0 0 0 0 0 0 0
0 0 0 0 0 0 0 0 0 0 0 0 0 0 0 0
0 0 3 3 3 3 3 2 2 3 3 3 3 3 0 0
0 0 3 3 3 3 3 2 2 3 3 3 3 3 0 0
0 0 3 3 3 3 3 3 3 3 3 3 3 3 0 0
0 0 3 3 3 3 3 3 3 3 3 3 3 3 0 0
0 0 3 3 3 3 3 3 3 3 3 3 3 3 0 0
1 1 3 3 3 3 3 3 3 3 3 3 2 2 0 0
1 1 3 3 3 3 3 7 3 3 3 3 2 2 0 0
0 0 3 24 3 3 3 3 3 3 3 3 23 3 0 0
0 0 3 3 3 3 3 4 4 3 3 3 3 3 0 0
0 0 4 4 3 3 4 4 4 4 3 3 4 4 0 0
0 0 4 4 4 4 4 4 4 4 4 4 4 4 0 0
0 0 4 4 4 4 4 4 4 4 4 4 4 4 0 0
0 0 0 0 0 0 0 0 0 0 0 0 0 0 0 0
0 0 0 0 0 0 0 0 0 0 0 0 0 0 0 0