0 0 0 0 0 0 0 1 1 0 0 0 0 0 0 0
0 0 0 0 0 0 0 1 1 0 0 0 0 0 0 0
0 0 4 4 4 4 3 3 3 3 3 3 3 3 0 0
0 0 4 3 3 12 3 3 3 3 3 3 3 3 0 0
0 0 4 7 3 3 3 25 3 3 3 3 3 3 0 0
0 0 4 3 3 3 3 3 3 3 3 3 3 3 0 0
0 0 4 4 4 4 16 4 16 16 3 3 3 3 0 0
0 0 3 3 3 3 3 3 3 3 3 3 2 2 0 0
0 0 3 3 3 3 3 3 3 3 3 3 2 2 0 0
0 0 3 3 3 3 3 3 3 3 3 3 3 3 0 0
0 0 3 3 3 3 3 5 3 3 3 3 3 3 0 0
0 0 3 3 3 3 3 3 3 3 23 3 3 20 0 0
0 0 3 3 3 3 3 2 2 3 3 3 3 3 0 0
0 0 4 4 4 4 4 2 2 3 4 4 4 4 0 0
0 0 0 0 0 0 0 0 0 0 0 0 0 0 0 0
0 0 0 0 0 0 0 0 0 0 0 0 0 0 0 0

0 0 0 0 0 0 0 0 0 0 0 0 0 0 0 0
0 0 0 0 0 0 0 0 0 0 0 0 0 0 0 0
0 0 3 3 3 3 3 2 2 3 3 3 3 3 0 0
0 0 3 3 3 3 3 2 2 3 3 3 3 3 0 0
0 0 3 3 3 3 3 3 3 3 3 3 3 3 0 0
0 0 3 3 3 3 3 3 3 3 3 3 3 3 0 0
0 0 3 3 3 3 3 3 16 16 16 3 3 3 0 0
1 1 3 16 16 16 3 3 3 3 3 3 23 3 1 1
1 1 3 3 3 3 3 3 3 3 3 3 3 3 1 1
0 0 3 3 3 16 16 16 16 3 3 3 4 16 0 0
0 0 3 3 3 3 3 3 3 3 3 3 3 3 0 0
0 0 3 16 16 16 3 3 16 16 16 3 23 5 0 0
0 0 3 3 3 3 3 3 3 3 3 3 3 3 0 0
0 0 4 4 4 4 4 4 4 4 4 4 4 4 0 0
0 0 0 0 0 0 0 0 0 0 0 0 0 0 0 0
0 0 0 0 0 0 0 0 0 0 0 0 0 0 0 0

0 0 0 0 0 0 0 1 1 0 0 0 0 0 0 0
0 0 0 0 0 0 0 1 1 0 0 0 0 0 0 0
0 0 4 4 4 4 3 3 3 4 4 4 4 4 0 0
0 0 4 4 3 3 3 3 3 3 3 4 4 4 0 0
0 0 4 4 24 3 3 3 3 3 23 4 4 4 0 0
0 0 4 4 3 3 3 3 3 3 3 4 4 4 0 0
0 0 4 4 4 4 3 3 3 4 4 4 4 4 0 0
0 0 4 4 4 4 3 5 3 4 4 4 4 4 0 0
0 0 4 4 4 4 3 3 3 4 4 4 4 4 0 0
0 0 4 4 4 4 3 3 3 4 4 4 4 4 0 0
0 0 4 4 3 3 3 3 3 3 3 4 4 4 0 0
0 0 4 4 24 3 3 3 3 3 23 4 4 4 0 0
0 0 4 4 3 3 3 3 3 3 3 4 4 4 0 0
0 0 4 4 4 4 3 3 3 4 4 4 4 4 0 0
0 0 0 0 0 0 0 1 1 0 0 0 0 0 0 0
0 0 0 0 0 0 0 1 1 0 0 0 0 0 0 0

0 0 0 0 0 0 0 1 1 0 0 0 0 0 0 0
0 0 0 0 0 0 0 1 1 0 0 0 0 0 0 0
0 0 4 4 4 4 4 10 10 10 4 4 4 4 0 0
0 0 4 4 4 4 3 3 3 3 3 3 3 3 0 0
0 0 4 4 4 4 3 3 3 3 3 3 3 3 0 0
0 0 4 4 4 4 3 3 3 3 3 3 3 3 0 0
0 0 4 4 4 4 3 3 3 3 4 4 3 3 0 0
1 1 3 3 4 4 3 3 3 3 3 3 3 3 0 0
1 1 3 3 4 3 3 3 3 3 23 3 3 3 0 0
0 0 3 3 3 3 3 3 3 9 3 3 3 8 0 0
0 0 4 5 20 3 3 3 3 4 4 4 4 4 0 0
0 0 4 3 3 3 3 3 3 4 4 4 4 4 0 0
0 0 4 4 4 4 9 9 9 4 4 4 4 4 0 0
0 0 4 4 4 4 4 4 4 4 4 4 4 4 0 0
0 0 0 0 0 0 0 0 0 0 0 0 0 0 0 0
0 0 0 0 0 0 0 0 0 0 0 0 0 0 0 0

0 0 0 0 0 0 0 0 0 0 0 0 0 0 0 0
0 0 0 0 0 0 0 0 0 0 0 0 0 0 0 0
0 0 3 3 3 3 3 2 2 3 3 3 16 16 0 0
0 0 3 3 3 3 3 2 2 3 3 16 16 3 0 0
0 0 16 16 16 16 3 3 3 3 16 16 3 3 0 0
0 0 3 3 3 16 16 3 3 16 16 3 3 3 0 0
0 0 3 3 3 3 16 16 16 16 3 3 3 3 0 0
0 0 2 2 3 3 3 16 16 3 3 3 2 2 0 0
0 0 2 2 3 3 3 16 16 3 3 3 2 2 0 0
0 0 3 3 3 3 3 3 16 16 3 3 3 3 0 0
0 0 3 24 3 3 5 3 3 16 16 3 3 3 0 0
0 0 3 3 3 3 3 3 3 3 16 16 16 16 0 0
0 0 4 4 3 3 3 2 2 3 3 3 3 3 0 0
0 0 4 4 3 3 3 2 2 3 3 3 3 3 0 0
0 0 0 0 0 0 0 0 0 0 0 0 0 0 0 0
0 0 0 0 0 0 0 0 0 0 0 0 0 0 0 0

0 0 0 0 0 0 0 1 1 0 0 0 0 0 0 0
0 0 0 0 0 0 0 1 1 0 0 0 0 0 0 0
0 0 3 3 3 3 3 3 3 3 3 3 3 3 0 0
0 0 9 3 3 3 9 9 9 9 9 3 3 9 0 0
0 0 4 3 3 3 4 4 4 4 4 3 3 4 0 0
0 0 4 3 3 3 4 4 4 4 4 3 3 4 0 0
0 0 4 3 3 3 3 3 3 3 3 3 3 4 0 0
1 1 4 3 3 3 24 3 11 3 23 3 3 4 1 1
1 1 4 3 3 3 3 3 3 3 3 3 3 4 1 1
0 0 3 16 16 16 4 4 4 4 4 16 16 3 0 0
0 0 3 3 3 3 3 3 3 3 3 3 3 3 0 0
0 0 3 3 3 3 3 3 3 3 3 3 3 3 0 0
0 0 3 3 3 3 3 3 3 3 3 3 3 3 0 0
0 0 4 4 4 4 4 4 4 4 4 4 4 4 0 0
0 0 0 0 0 0 0 0 0 0 0 0 0 0 0 0
0 0 0 0 0 0 0 0 0 0 0 0 0 0 0 0