0 0 0 0 0 0 0 0 0 0 0 0 0 0 0 0
0 0 0 0 0 0 0 0 0 0 0 0 0 0 0 0
0 0 3 3 3 3 3 2 2 3 3 3 3 3 0 0
0 0 3 3 3 3 3 2 2 3 3 3 3 3 0 0
0 0 3 3 3 3 3 3 3 3 3 3 3 3 0 0
0 0 4 4 4 4 4 4 4 4 4 3 3 3 0 0
0 0 3 3 3 3 3 3 3 3 3 3 5 3 0 0
0 0 2 2 3 3 3 3 3 3 3 3 2 2 0 0
0 0 2 2 3 3 3 3 3 3 3 3 2 2 0 0
0 0 3 3 3 3 3 3 3 3 3 4 4 4 0 0
0 0 3 3 3 3 3 3 3 4 3 4 4 4 0 0
0 0 3 25 20 3 3 4 3 4 3 4 4 4 0 0
0 0 3 3 3 4 3 4 3 4 3 4 4 4 0 0
0 0 4 4 4 4 9 4 9 4 9 4 4 4 0 0
0 0 0 0 0 0 0 0 0 0 0 0 0 0 0 0
0 0 0 0 0 0 0 0 0 0 0 0 0 0 0 0

0 0 0 0 0 0 0 1 1 0 0 0 0 0 0 0
0 0 0 0 0 0 0 1 1 0 0 0 0 0 0 0
0 0 3 3 3 3 3 3 3 3 3 3 3 4 0 0
0 0 3 3 3 3 3 3 3 3 3 3 3 4 0 0
0 0 3 3 3 3 3 3 3 3 3 3 3 4 0 0
0 0 3 3 3 3 3 3 3 3 3 3 3 4 0 0
0 0 3 3 3 3 3 3 3 3 3 3 3 4 0 0
1 1 3 3 3 3 3 3 3 3 3 3 2 2 0 0
1 1 3 3 3 3 3 3 3 3 3 3 2 2 0 0
0 0 3 8 3 3 3 3 3 3 3 3 3 4 0 0
0 0 3 3 3 3 3 3 3 3 3 3 3 4 0 0
0 0 3 3 3 3 3 3 3 4 4 4 4 4 0 0
0 0 3 3 3 3 3 5 3 4 4 4 4 4 0 0
0 0 4 4 4 4 9 9 9 4 4 4 4 4 0 0
0 0 0 0 0 0 0 1 1 0 0 0 0 0 0 0
0 0 0 0 0 0 0 1 1 0 0 0 0 0 0 0

0 0 0 0 0 0 0 1 1 0 0 0 0 0 0 0
0 0 0 0 0 0 0 1 1 0 0 0 0 0 0 0
0 0 3 3 3 4 4 4 4 4 4 4 4 4 0 0
0 0 3 3 3 4 4 4 4 4 4 4 4 4 0 0
0 0 3 3 3 4 4 4 4 4 4 4 4 4 0 0
0 0 3 3 3 3 3 3 3 3 3 3 3 4 0 0
0 0 4 3 3 3 3 3 3 3 3 3 3 3 0 0
1 1 4 4 3 3 5 3 3 3 3 3 2 2 0 0
1 1 4 4 4 3 3 3 3 3 3 3 2 2 0 0
0 0 4 4 4 4 4 4 4 3 3 3 3 3 0 0
0 0 4 4 4 4 4 4 4 3 3 3 3 3 0 0
0 0 4 4 4 4 4 4 4 3 3 3 3 3 0 0
0 0 4 4 4 4 4 4 4 3 3 3 3 3 0 0
0 0 4 4 4 4 4 4 4 4 4 4 4 4 0 0
0 0 0 0 0 0 0 0 0 0 0 0 0 0 0 0
0 0 0 0 0 0 0 0 0 0 0 0 0 0 0 0

0 0 0 0 0 0 0 1 1 0 0 0 0 0 0 0
0 0 0 0 0 0 0 1 1 0 0 0 0 0 0 0
0 0 4 4 4 4 4 18 18 4 4 4 4 4 0 0
0 0 4 4 4 4 4 3 3 4 4 4 4 4 0 0
0 0 4 4 4 3 3 3 5 3 3 4 4 4 0 0
0 0 4 4 4 3 3 3 3 3 3 4 4 4 0 0
0 0 4 4 4 3 3 20 3 3 3 4 4 4 0 0
0 0 4 4 4 3 3 3 3 3 3 4 4 4 0 0
0 0 4 4 4 3 4 4 4 4 3 4 4 4 0 0
0 0 4 4 4 3 4 4 4 4 3 4 4 4 0 0
0 0 4 4 4 3 4 4 4 4 3 4 4 4 0 0
0 0 4 4 4 3 4 4 4 4 3 4 4 4 0 0
0 0 4 4 4 3 4 2 2 4 3 4 4 4 0 0
0 0 4 4 4 3 4 2 2 4 3 4 4 4 0 0
0 0 0 0 0 0 0 0 0 0 0 0 0 0 0 0
0 0 0 0 0 0 0 0 0 0 0 0 0 0 0 0

0 0 0 0 0 0 0 1 1 0 0 0 0 0 0 0
0 0 0 0 0 0 0 1 1 0 0 0 0 0 0 0
0 0 4 4 4 3 4 4 4 4 9 4 4 4 0 0
0 0 4 4 4 3 4 4 4 4 3 4 4 4 0 0
0 0 4 4 4 3 4 4 4 4 3 4 4 4 0 0
0 0 9 3 3 3 3 3 3 3 3 3 3 9 0 0
0 0 4 4 4 3 4 4 4 4 3 4 4 4 0 0
1 1 4 4 4 3 4 4 4 4 3 4 4 4 1 1
1 1 4 4 4 3 4 4 4 4 3 4 4 4 1 1
0 0 4 4 4 3 4 4 4 4 3 4 4 4 0 0
0 0 3 3 3 3 3 3 3 3 7 3 3 3 0 0
0 0 4 4 4 3 4 4 4 4 3 4 4 4 0 0
0 0 4 4 4 3 4 4 4 4 3 4 4 4 0 0
0 0 4 4 4 9 4 4 4 4 3 4 4 4 0 0
0 0 0 0 0 0 0 1 1 0 0 0 0 0 0 0
0 0 0 0 0 0 0 1 1 0 0 0 0 0 0 0