0 0 0 0 0 0 0 0 0 0 0 0 0 0 0 0
0 0 0 0 0 0 0 0 0 0 0 0 0 0 0 0
0 0 3 3 3 3 3 2 2 3 3 3 3 3 0 0
0 0 3 3 3 3 3 2 2 3 3 3 3 3 0 0
0 0 3 3 3 3 3 3 3 3 3 3 3 3 0 0
0 0 3 3 3 3 3 3 3 3 3 3 3 3 0 0
0 0 3 3 3 3 3 3 3 3 3 3 4 4 0 0
0 0 2 2 3 3 3 3 16 16 3 3 2 2 0 0
0 0 2 2 3 3 3 3 3 3 3 3 2 2 0 0
0 0 3 25 3 4 4 3 5 3 3 3 3 3 0 0
0 0 3 3 3 4 4 3 3 3 3 3 3 3 0 0
0 0 4 4 4 4 4 4 4 4 4 3 36 3 0 0
0 0 4 4 4 4 4 4 4 4 4 4 4 4 0 0
0 0 4 4 4 4 4 4 4 4 4 4 4 4 0 0
0 0 0 0 0 0 0 0 0 0 0 0 0 0 0 0
0 0 0 0 0 0 0 0 0 0 0 0 0 0 0 0

0 0 0 0 0 0 0 0 0 0 0 0 0 0 0 0
0 0 0 0 0 0 0 0 0 0 0 0 0 0 0 0
0 0 4 4 4 4 4 4 4 4 4 4 4 4 0 0
0 0 4 4 4 4 4 4 4 4 4 4 4 4 0 0
0 0 4 13 4 3 3 3 3 3 3 3 3 14 0 0
0 0 3 3 3 3 3 3 11 3 3 3 3 3 0 0
0 0 3 3 3 3 3 3 3 3 3 3 3 3 0 0
0 0 2 2 4 3 3 3 3 3 3 3 3 4 1 1
0 0 2 2 4 3 3 3 3 3 3 3 4 4 1 1
0 0 3 3 4 4 4 4 4 4 4 4 4 3 0 0
0 0 3 3 4 4 4 3 3 3 12 3 3 3 0 0
0 0 3 3 4 4 4 3 5 3 3 3 3 3 0 0
0 0 3 3 4 4 4 3 3 3 3 3 3 3 0 0
0 0 3 3 4 4 4 4 4 4 4 3 3 3 0 0
0 0 0 0 0 0 0 0 0 0 0 0 0 0 0 0
0 0 0 0 0 0 0 0 0 0 0 0 0 0 0 0

0 0 0 0 0 0 0 0 0 0 0 0 0 0 0 0
0 0 0 0 0 0 0 0 0 0 0 0 0 0 0 0
0 0 4 4 4 4 3 2 2 3 4 4 4 4 0 0
0 0 3 3 4 4 3 2 2 3 4 4 3 3 0 0
0 0 3 3 3 3 3 3 3 3 3 3 3 3 0 0
0 0 3 3 3 3 3 3 3 3 3 5 3 3 0 0
0 0 3 3 3 3 3 3 3 3 3 3 3 3 0 0
1 1 4 4 3 3 3 3 3 3 3 3 4 4 1 1
1 1 4 4 4 4 3 3 3 3 4 4 4 4 1 1
0 0 3 3 3 3 3 3 3 3 3 3 3 3 0 0
0 0 3 3 3 3 3 8 3 3 3 3 3 3 0 0
0 0 3 3 3 3 3 3 3 3 3 3 3 3 0 0
0 0 3 3 3 3 4 4 4 4 3 3 3 3 0 0
0 0 4 4 4 4 4 4 4 4 4 4 4 4 0 0
0 0 0 0 0 0 0 0 0 0 0 0 0 0 0 0
0 0 0 0 0 0 0 0 0 0 0 0 0 0 0 0


0 0 0 0 0 0 0 1 1 0 0 0 0 0 0 0
0 0 0 0 0 0 0 1 1 0 0 0 0 0 0 0
0 0 4 4 3 3 3 3 3 3 3 3 3 3 0 0
0 0 4 4 3 3 3 3 3 3 3 3 3 3 0 0
0 0 4 4 3 3 3 3 3 3 3 3 3 3 0 0
0 0 4 4 13 4 4 3 3 3 3 3 3 3 0 0
0 0 4 4 4 4 3 3 3 3 3 3 3 3 0 0
0 0 2 2 3 3 3 3 3 3 3 3 2 2 0 0
0 0 2 2 3 3 3 3 4 4 4 4 2 2 0 0
0 0 3 3 3 3 3 3 14 3 3 3 4 4 0 0
0 0 3 3 3 3 3 3 3 3 5 3 4 4 0 0
0 0 3 3 3 3 3 3 3 3 3 3 4 4 0 0
0 0 4 4 4 4 4 4 4 4 4 4 4 4 0 0
0 0 4 4 4 4 4 4 4 4 4 4 4 4 0 0
0 0 0 0 0 0 0 0 0 0 0 0 0 0 0 0
0 0 0 0 0 0 0 0 0 0 0 0 0 0 0 0


0 0 0 0 0 0 0 0 0 0 0 0 0 0 0 0
0 0 0 0 0 0 0 0 0 0 0 0 0 0 0 0
0 0 3 3 3 3 3 3 3 3 4 4 4 4 0 0
0 0 3 3 3 3 3 3 3 3 12 3 3 4 0 0
0 0 3 3 3 3 3 3 3 3 3 5 3 4 0 0
0 0 3 3 3 3 3 3 3 3 3 3 3 4 0 0
0 0 4 4 4 4 4 4 4 4 4 4 36 4 0 0
0 0 2 2 4 4 4 4 4 4 4 4 4 4 1 1
0 0 2 2 3 3 3 3 3 3 3 3 3 3 1 1
0 0 4 3 37 3 3 3 3 3 3 3 3 3 0 0
0 0 4 3 35 11 3 3 3 3 3 3 3 3 0 0
0 0 4 3 3 3 3 3 3 3 3 3 3 3 0 0
0 0 4 4 4 4 4 3 3 4 3 3 4 4 0 0
0 0 4 4 4 4 4 9 9 4 9 9 4 4 0 0
0 0 0 0 0 0 0 0 0 0 0 0 0 0 0 0
0 0 0 0 0 0 0 0 0 0 0 0 0 0 0 0


0 0 0 0 0 0 0 0 0 0 0 0 0 0 0 0
0 0 0 0 0 0 0 0 0 0 0 0 0 0 0 0
0 0 4 4 4 4 4 4 4 4 4 4 4 4 0 0
0 0 3 3 3 3 3 3 3 3 3 4 4 4 0 0
0 0 3 3 3 3 3 21 3 3 3 4 4 4 0 0
0 0 3 3 3 3 3 3 3 3 3 4 4 4 0 0
0 0 3 3 3 3 4 4 4 4 3 4 4 4 0 0
0 0 2 2 4 4 4 4 4 4 3 4 4 4 1 1
0 0 2 2 4 4 4 4 4 4 3 4 4 4 1 1
0 0 3 3 3 3 3 14 3 3 3 4 3 3 0 0
0 0 3 3 3 3 3 3 3 5 3 3 3 3 0 0
0 0 3 3 3 3 3 3 3 3 3 3 3 3 0 0
0 0 4 4 4 4 4 4 4 4 4 4 13 4 0 0
0 0 4 4 4 4 4 4 4 4 4 4 4 4 0 0
0 0 0 0 0 0 0 0 0 0 0 0 0 0 0 0
0 0 0 0 0 0 0 0 0 0 0 0 0 0 0 0


0 0 0 0 0 0 0 1 1 0 0 0 0 0 0 0
0 0 0 0 0 0 0 1 1 0 0 0 0 0 0 0
0 0 4 4 4 4 4 4 3 3 3 3 3 3 0 0
0 0 4 4 4 4 4 4 3 3 3 3 3 3 0 0
0 0 4 4 4 4 4 4 3 3 4 4 4 4 0 0
0 0 4 4 4 4 4 4 3 3 12 3 3 4 0 0
0 0 3 3 3 3 3 3 3 3 3 3 35 4 0 0
0 0 2 2 3 3 3 3 3 3 3 3 3 4 1 1
0 0 2 2 3 3 3 3 3 4 4 4 4 4 1 1
0 0 3 3 3 3 3 3 3 3 3 3 3 3 0 0
0 0 3 3 3 3 3 3 3 3 3 3 3 3 0 0
0 0 3 3 11 3 3 3 3 3 3 3 3 3 0 0
0 0 3 3 3 3 3 3 4 4 4 3 36 3 0 0
0 0 9 9 9 9 9 18 4 4 4 4 4 4 0 0
0 0 0 0 0 0 0 1 1 0 0 0 0 0 0 0
0 0 0 0 0 0 0 1 1 0 0 0 0 0 0 0


0 0 0 0 0 0 0 0 0 0 0 0 0 0 0 0
0 0 0 0 0 0 0 0 0 0 0 0 0 0 0 0
0 0 3 3 3 3 3 3 3 3 3 3 3 3 0 0
0 0 3 3 3 3 3 3 3 3 3 3 3 3 0 0
0 0 3 3 3 3 3 3 3 3 3 3 3 37 0 0
0 0 3 3 3 3 3 3 3 3 3 3 3 3 0 0
0 0 3 3 3 3 3 3 3 3 3 3 3 3 0 0
1 1 3 35 3 3 3 3 3 4 4 3 22 3 0 0
1 1 3 3 3 4 4 3 3 4 4 3 3 3 0 0
0 0 4 4 4 4 4 3 3 4 4 4 4 4 0 0
0 0 4 4 4 4 4 3 3 4 4 4 4 4 0 0
0 0 4 4 4 4 4 3 3 4 4 4 4 4 0 0
0 0 4 4 4 4 4 3 3 4 4 4 4 4 0 0
0 0 4 4 4 4 4 3 3 4 4 4 4 4 0 0
0 0 0 0 0 0 0 0 0 0 0 0 0 0 0 0
0 0 0 0 0 0 0 0 0 0 0 0 0 0 0 0
