0 0 0 0 0 0 0 1 1 0 0 0 0 0 0 0
0 0 0 0 0 0 0 1 1 0 0 0 0 0 0 0
0 0 4 4 4 4 3 3 3 3 3 3 3 3 0 0
0 0 4 3 3 12 3 3 3 3 3 3 3 3 0 0
0 0 4 7 3 3 3 3 3 3 3 3 3 3 0 0
0 0 4 3 3 3 3 25 3 3 3 3 3 3 0 0
0 0 4 4 4 4 16 16 16 3 3 3 3 3 0 0
0 0 3 3 3 3 3 3 3 3 3 3 2 2 0 0
0 0 3 3 3 3 3 3 3 3 3 3 2 2 0 0
0 0 3 3 3 3 3 3 3 3 3 3 3 3 0 0
0 0 3 3 3 3 3 5 3 3 3 3 3 3 0 0
0 0 3 3 3 3 3 3 3 3 23 3 3 20 0 0
0 0 3 3 3 3 3 2 2 3 3 3 3 3 0 0
0 0 4 4 4 4 4 2 2 3 4 4 4 4 0 0
0 0 0 0 0 0 0 0 0 0 0 0 0 0 0 0
0 0 0 0 0 0 0 0 0 0 0 0 0 0 0 0

0 0 0 0 0 0 0 0 0 0 0 0 0 0 0 0
0 0 0 0 0 0 0 0 0 0 0 0 0 0 0 0
0 0 3 3 3 3 3 2 2 3 3 3 3 3 0 0
0 0 3 3 3 3 3 2 2 3 3 3 3 3 0 0
0 0 3 3 3 3 3 3 3 3 3 3 3 3 0 0
0 0 3 3 3 3 3 3 3 3 3 3 3 3 0 0
0 0 3 3 3 3 3 3 3 3 3 3 3 3 0 0
1 1 3 3 3 3 3 3 3 3 3 3 3 3 1 1
1 1 3 3 3 3 3 3 3 3 3 3 3 3 1 1
0 0 3 3 3 3 3 3 3 3 3 3 5 3 0 0
0 0 3 3 3 3 3 3 3 3 3 3 23 3 0 0
0 0 3 3 3 3 3 3 3 3 3 3 3 3 0 0
0 0 4 4 8 4 4 8 4 8 4 4 4 4 0 0
0 0 4 4 4 4 4 4 4 4 4 4 4 4 0 0
0 0 0 0 0 0 0 0 0 0 0 0 0 0 0 0
0 0 0 0 0 0 0 0 0 0 0 0 0 0 0 0

0 0 0 0 0 0 0 1 1 0 0 0 0 0 0 0
0 0 0 0 0 0 0 1 1 0 0 0 0 0 0 0
0 0 4 4 4 4 3 3 3 4 4 4 4 4 0 0
0 0 4 4 3 3 3 3 3 3 3 4 4 4 0 0
0 0 4 4 23 3 3 3 3 3 23 4 4 4 0 0
0 0 4 4 3 3 3 3 3 3 3 4 4 4 0 0
0 0 4 4 4 4 3 3 3 4 4 4 4 4 0 0
0 0 4 4 4 4 3 5 3 4 4 4 4 4 0 0
0 0 4 4 4 4 3 3 3 4 4 4 4 4 0 0
0 0 4 4 4 4 3 3 3 4 4 4 4 4 0 0
0 0 4 4 3 3 3 3 3 3 3 4 4 4 0 0
0 0 4 4 23 3 3 3 3 3 23 4 4 4 0 0
0 0 4 4 3 3 3 3 3 3 3 4 4 4 0 0
0 0 4 4 4 4 3 3 3 4 4 4 4 4 0 0
0 0 0 0 0 0 0 1 1 0 0 0 0 0 0 0
0 0 0 0 0 0 0 1 1 0 0 0 0 0 0 0

0 0 0 0 0 0 0 1 1 0 0 0 0 0 0 0
0 0 0 0 0 0 0 1 1 0 0 0 0 0 0 0
0 0 4 4 4 4 4 10 10 10 4 4 4 4 0 0
0 0 4 4 4 4 3 3 3 3 3 3 3 3 0 0
0 0 4 4 4 4 3 3 3 3 3 3 3 3 0 0
0 0 4 4 4 4 3 3 3 3 3 3 3 3 0 0
0 0 4 4 4 4 3 3 3 3 4 4 3 3 0 0
0 0 2 2 4 4 3 3 3 3 3 3 3 3 0 0
0 0 2 2 4 3 3 3 3 3 23 3 3 3 0 0
0 0 3 3 3 3 3 3 3 9 3 3 3 8 0 0
0 0 3 5 20 3 3 3 3 4 4 4 4 4 0 0
0 0 3 3 3 3 3 3 3 4 4 4 4 4 0 0
0 0 4 4 4 4 9 9 9 4 4 4 4 4 0 0
0 0 4 4 4 4 4 4 4 4 4 4 4 4 0 0
0 0 0 0 0 0 0 0 0 0 0 0 0 0 0 0
0 0 0 0 0 0 0 0 0 0 0 0 0 0 0 0

0 0 0 0 0 0 0 1 1 0 0 0 0 0 0 0
0 0 0 0 0 0 0 1 1 0 0 0 0 0 0 0
0 0 4 4 4 3 3 3 3 3 3 3 3 3 0 0
0 0 4 8 4 3 3 3 3 3 3 3 3 3 0 0
0 0 4 4 3 3 3 3 3 3 3 3 3 3 0 0
0 0 3 3 3 3 3 3 3 3 3 3 3 3 0 0
0 0 3 3 3 3 3 3 3 3 3 3 3 3 0 0
0 0 3 3 3 3 3 3 3 3 3 3 3 3 1 1
0 0 3 3 3 3 3 3 3 3 3 3 3 3 1 1
0 0 3 3 3 5 3 3 3 3 3 3 3 3 0 0
0 0 3 3 3 23 3 3 3 3 3 3 3 3 0 0
0 0 3 3 3 3 3 3 3 3 3 3 3 3 0 0
0 0 4 4 4 4 4 4 4 4 4 4 4 4 0 0
0 0 4 4 4 4 4 4 4 4 4 4 4 4 0 0
0 0 0 0 0 0 0 0 0 0 0 0 0 0 0 0
0 0 0 0 0 0 0 0 0 0 0 0 0 0 0 0

0 0 0 0 0 0 0 0 0 0 0 0 0 0 0 0
0 0 0 0 0 0 0 0 0 0 0 0 0 0 0 0
0 0 4 3 3 3 3 2 2 3 8 3 6 3 0 0
0 0 4 3 3 3 3 2 2 3 3 3 3 3 0 0
0 0 4 4 3 3 3 3 3 4 4 4 4 4 0 0
0 0 4 4 3 3 3 3 3 3 3 3 3 3 0 0
0 0 4 4 4 3 3 3 3 3 3 3 3 3 0 0
0 0 2 2 4 4 3 3 3 3 3 3 3 3 0 0
0 0 2 2 3 3 3 3 3 3 3 3 3 3 0 0
0 0 3 3 6 3 3 3 3 3 3 3 3 3 0 0
0 0 3 3 3 3 3 3 3 3 3 3 3 3 0 0
0 0 3 3 3 3 4 3 3 3 3 23 7 3 0 0
0 0 3 3 3 3 4 3 3 3 3 3 3 3 0 0
0 0 4 4 4 4 4 4 4 4 4 4 4 4 0 0
0 0 0 0 0 0 0 0 0 0 0 0 0 0 0 0
0 0 0 0 0 0 0 0 0 0 0 0 0 0 0 0