0 0 0 0 0 0 0 1 1 0 0 0 0 0 0 0
0 0 0 0 0 0 0 1 1 0 0 0 0 0 0 0
0 0 4 4 4 4 4 4 4 4 4 4 4 4 0 0
0 0 4 4 4 4 4 4 4 4 4 4 4 4 0 0
0 0 3 3 3 3 3 3 3 3 3 3 3 3 0 0
0 0 3 3 3 3 3 3 3 3 3 3 3 3 0 0
0 0 3 3 3 3 3 3 3 3 3 3 3 3 0 0
1 1 3 3 3 3 3 3 3 3 3 4 4 4 1 1
1 1 3 3 3 3 3 3 3 3 3 14 3 4 1 1
0 0 4 3 25 3 3 20 21 3 3 3 5 4 0 0
0 0 4 4 3 3 3 3 3 3 3 3 3 4 0 0
0 0 4 4 4 4 3 4 4 4 3 4 4 4 0 0
0 0 4 4 4 4 13 4 4 4 3 4 4 4 0 0
0 0 4 4 4 4 4 4 4 4 3 4 4 4 0 0
0 0 0 0 0 0 0 1 1 0 0 0 0 0 0 0
0 0 0 0 0 0 0 1 1 0 0 0 0 0 0 0

0 0 0 0 0 0 0 0 0 0 0 0 0 0 0 0
0 0 0 0 0 0 0 0 0 0 0 0 0 0 0 0
0 0 3 3 3 3 3 2 2 3 3 3 3 3 0 0
0 0 3 3 3 3 3 2 2 3 3 3 3 3 0 0
0 0 3 3 3 3 3 3 3 3 3 3 3 3 0 0
0 0 3 3 3 3 3 3 3 3 3 3 3 3 0 0
0 0 3 3 3 3 3 3 3 3 3 3 3 3 0 0
0 0 2 2 3 3 5 3 3 3 3 3 2 2 0 0
0 0 2 2 3 3 3 3 3 3 3 3 2 2 0 0
0 0 3 3 3 3 4 3 3 3 3 3 3 3 0 0
0 0 3 3 3 3 4 3 3 3 3 3 3 3 0 0
0 0 3 3 3 3 4 3 3 3 3 3 3 3 0 0
0 0 4 4 4 4 4 4 4 3 3 3 4 4 0 0
0 0 4 4 4 4 4 4 4 4 4 4 4 4 0 0
0 0 0 0 0 0 0 0 0 0 0 0 0 0 0 0
0 0 0 0 0 0 0 0 0 0 0 0 0 0 0 0

0 0 0 0 0 0 0 1 1 0 0 0 0 0 0 0
0 0 0 0 0 0 0 1 1 0 0 0 0 0 0 0
0 0 4 4 4 4 4 4 4 4 4 4 4 4 0 0
0 0 3 3 3 3 3 3 3 3 13 4 4 4 0 0
0 0 3 3 3 3 3 3 3 3 4 4 4 4 0 0
0 0 3 3 3 3 3 3 3 3 3 14 3 4 0 0
0 0 3 3 3 3 3 3 3 3 3 3 5 4 0 0
0 0 2 2 3 3 3 3 3 3 3 3 3 4 0 0
0 0 2 2 3 3 3 3 3 3 4 4 4 4 0 0
0 0 3 3 3 3 3 3 3 3 4 4 4 4 0 0
0 0 3 3 3 3 3 3 3 3 4 4 4 4 0 0
0 0 3 3 3 3 3 3 3 3 4 4 4 4 0 0
0 0 3 3 3 3 3 2 2 3 4 4 4 4 0 0
0 0 3 3 3 3 3 2 2 3 4 4 4 4 0 0
0 0 0 0 0 0 0 0 0 0 0 0 0 0 0 0
0 0 0 0 0 0 0 0 0 0 0 0 0 0 0 0

0 0 0 0 0 0 0 0 0 0 0 0 0 0 0 0
0 0 0 0 0 0 0 0 0 0 0 0 0 0 0 0
0 0 4 4 4 4 4 2 2 3 3 3 3 3 0 0
0 0 4 4 4 4 4 2 2 3 3 3 3 3 0 0
0 0 4 4 4 4 4 4 4 3 3 3 3 3 0 0
0 0 4 4 4 4 4 4 4 3 3 3 3 3 0 0
0 0 4 4 4 4 4 4 4 3 3 3 3 3 0 0
0 0 2 2 4 4 4 4 4 3 3 3 3 3 0 0
0 0 2 2 4 4 4 4 4 3 3 3 3 3 0 0
0 0 3 3 3 3 14 3 3 3 3 3 3 3 0 0
0 0 3 3 3 5 3 3 3 3 3 3 3 3 0 0
0 0 3 3 3 3 3 3 3 13 18 3 3 3 0 0
0 0 9 9 9 4 4 4 4 4 4 4 4 4 0 0
0 0 4 4 4 4 4 4 4 4 4 4 4 4 0 0
0 0 0 0 0 0 0 0 0 0 0 0 0 0 0 0
0 0 0 0 0 0 0 0 0 0 0 0 0 0 0 0

0 0 0 0 0 0 0 0 0 0 0 0 0 0 0 0
0 0 0 0 0 0 0 0 0 0 0 0 0 0 0 0
0 0 3 3 3 3 3 2 2 3 3 4 4 4 0 0
0 0 3 3 3 3 3 2 2 3 3 4 4 4 0 0
0 0 3 3 3 3 3 3 3 3 3 9 9 9 0 0
0 0 3 3 3 3 3 3 3 3 3 3 3 3 0 0
0 0 3 3 3 3 3 3 3 3 3 3 7 3 0 0
0 0 2 2 3 3 3 3 3 3 3 3 3 3 0 0
0 0 2 2 3 3 3 3 3 3 3 3 3 3 0 0
0 0 3 3 3 3 3 3 3 3 3 4 4 4 0 0
0 0 3 3 3 3 3 3 3 3 3 4 4 4 0 0
0 0 3 3 3 3 3 3 3 3 3 4 4 4 0 0
0 0 4 4 4 4 4 9 9 9 9 4 4 4 0 0
0 0 4 4 4 4 4 4 4 4 4 4 4 4 0 0
0 0 0 0 0 0 0 0 0 0 0 0 0 0 0 0
0 0 0 0 0 0 0 0 0 0 0 0 0 0 0 0