0 0 0 0 0 0 0 0 0 0 0 0 0 0 0 0
0 0 0 0 0 0 0 0 0 0 0 0 0 0 0 0
0 0 4 4 4 4 4 2 2 4 4 4 4 4 0 0
0 0 4 4 4 4 4 2 2 4 4 4 4 4 0 0
0 0 4 4 4 4 4 3 3 4 4 4 4 4 0 0
0 0 4 4 4 4 4 3 3 4 4 4 4 4 0 0
0 0 4 4 4 4 4 3 3 4 4 4 4 4 0 0
1 1 3 3 3 3 3 3 3 4 4 4 4 4 1 1
1 1 3 3 3 3 3 3 3 3 3 3 3 3 1 1
0 0 3 3 3 3 3 3 3 3 3 3 3 3 0 0
0 0 3 3 3 5 3 3 3 3 3 3 3 3 0 0
0 0 3 25 20 3 3 3 3 3 3 3 6 3 0 0
0 0 3 3 3 3 3 2 2 3 3 3 3 3 0 0
0 0 4 4 4 4 4 2 2 4 4 4 4 4 0 0
0 0 0 0 0 0 0 0 0 0 0 0 0 0 0 0
0 0 0 0 0 0 0 0 0 0 0 0 0 0 0 0

0 0 0 0 0 0 0 1 1 0 0 0 0 0 0 0
0 0 0 0 0 0 0 1 1 0 0 0 0 0 0 0
0 0 3 3 3 3 3 3 3 3 3 3 3 3 0 0
0 0 3 3 3 3 3 3 3 3 3 3 3 3 0 0
0 0 3 3 3 3 3 3 3 3 3 3 3 3 0 0
0 0 3 3 3 3 3 3 3 3 4 4 3 3 0 0
0 0 3 3 3 3 3 3 3 3 3 5 3 3 0 0
0 0 2 2 3 3 3 3 3 3 3 3 2 2 0 0
0 0 2 2 3 3 3 3 3 3 3 3 2 2 0 0
0 0 3 3 3 3 3 3 3 3 3 3 3 3 0 0
0 0 3 3 3 3 3 3 6 3 3 3 3 4 0 0
0 0 3 3 3 3 3 3 3 3 3 3 3 4 0 0
0 0 3 3 3 3 3 3 3 3 3 3 3 4 0 0
0 0 3 3 3 4 4 4 4 4 4 4 4 4 0 0
0 0 0 0 0 0 0 0 0 0 0 0 0 0 0 0
0 0 0 0 0 0 0 0 0 0 0 0 0 0 0 0

0 0 0 0 0 0 0 1 1 0 0 0 0 0 0 0
0 0 0 0 0 0 0 1 1 0 0 0 0 0 0 0
0 0 4 4 4 4 4 4 4 4 4 4 3 3 0 0
0 0 4 4 4 4 4 4 4 4 4 4 3 3 0 0
0 0 4 4 4 4 4 4 4 4 4 4 3 3 0 0
0 0 4 4 4 4 4 4 4 4 4 4 3 3 0 0
0 0 4 4 4 4 4 4 4 4 4 4 3 3 0 0
0 0 4 4 4 4 4 4 4 4 4 4 2 2 0 0
0 0 4 4 4 4 4 4 4 4 4 4 2 2 0 0
0 0 4 4 4 4 4 4 4 4 4 4 3 3 0 0
0 0 4 4 4 4 4 4 3 3 3 17 3 3 0 0
0 0 4 4 4 4 4 4 8 5 3 17 3 3 0 0
0 0 4 4 4 4 4 4 3 3 3 17 3 3 0 0
0 0 4 4 4 4 4 4 4 4 4 4 3 3 0 0
0 0 0 0 0 0 0 0 0 0 0 0 0 0 0 0
0 0 0 0 0 0 0 0 0 0 0 0 0 0 0 0

0 0 0 0 0 0 0 0 0 0 0 0 0 0 0 0
0 0 0 0 0 0 0 0 0 0 0 0 0 0 0 0
0 0 4 4 4 4 4 2 2 4 4 4 4 4 0 0
0 0 4 9 9 9 9 2 2 3 3 3 3 4 0 0
0 0 4 3 3 3 3 3 3 3 3 3 3 4 0 0
0 0 4 3 3 3 3 3 3 3 3 3 3 4 0 0
0 0 4 3 3 3 3 3 3 3 3 3 3 4 0 0
0 0 4 3 3 3 9 9 9 9 3 3 3 4 0 0
0 0 4 3 3 3 4 4 4 4 3 3 3 4 0 0
0 0 4 3 3 3 4 4 4 4 3 5 3 4 0 0
0 0 4 3 3 3 4 4 4 4 3 3 3 4 0 0
0 0 4 3 3 3 4 4 4 4 3 3 3 4 0 0
0 0 4 3 3 3 4 2 2 4 3 3 3 4 0 0
0 0 4 3 3 3 4 2 2 4 3 3 3 4 0 0
0 0 0 0 0 0 0 0 0 0 0 0 0 0 0 0
0 0 0 0 0 0 0 0 0 0 0 0 0 0 0 0

0 0 0 0 0 0 0 0 0 0 0 0 0 0 0 0
0 0 0 0 0 0 0 0 0 0 0 0 0 0 0 0
0 0 4 4 4 4 4 2 2 3 4 4 4 4 0 0
0 0 4 4 4 4 4 2 2 3 4 4 4 4 0 0
0 0 4 4 4 4 4 3 3 3 4 4 4 4 0 0
0 0 4 4 4 4 4 3 7 3 4 4 4 4 0 0
0 0 4 4 4 4 4 3 3 3 4 4 4 4 0 0
0 0 4 4 4 4 4 9 9 9 4 4 4 4 0 0
0 0 4 4 4 4 4 4 4 4 4 4 4 4 0 0
0 0 4 4 4 4 4 4 4 4 4 4 4 4 0 0
0 0 4 4 4 4 4 4 4 4 4 4 4 4 0 0
0 0 4 4 4 4 4 4 4 4 4 4 4 4 0 0
0 0 4 4 4 4 4 2 2 4 4 4 4 4 0 0
0 0 4 4 4 4 4 2 2 4 4 4 4 4 0 0
0 0 0 0 0 0 0 0 0 0 0 0 0 0 0 0
0 0 0 0 0 0 0 0 0 0 0 0 0 0 0 0