0 0 0 0 0 0 0 0 0 0 0 0 0 0 0 0
0 0 0 0 0 0 0 0 0 0 0 0 0 0 0 0
0 0 4 4 3 3 3 2 2 3 3 3 3 3 0 0
0 0 4 4 3 3 3 2 2 3 3 3 3 3 0 0
0 0 4 4 3 3 3 3 3 3 3 3 3 3 0 0
0 0 4 4 3 3 3 3 3 3 3 3 3 3 0 0
0 0 4 4 3 3 3 3 3 3 3 4 4 4 0 0
0 0 4 4 3 3 3 3 3 3 3 4 2 2 0 0
0 0 4 4 3 3 3 3 3 3 3 4 2 2 0 0
0 0 4 4 3 3 3 8 3 3 3 14 3 3 0 0
0 0 4 4 3 3 3 4 4 3 3 14 5 3 0 0
0 0 4 4 3 13 3 4 4 3 3 14 3 3 0 0
0 0 4 4 4 4 4 4 4 4 4 4 4 4 0 0
0 0 4 4 4 4 4 4 4 4 4 4 4 4 0 0
0 0 0 0 0 0 0 0 0 0 0 0 0 0 0 0
0 0 0 0 0 0 0 0 0 0 0 0 0 0 0 0

0 0 0 0 0 0 0 0 0 0 0 0 0 0 0 0
0 0 0 0 0 0 0 0 0 0 0 0 0 0 0 0
0 0 3 3 3 3 3 2 2 3 3 3 3 3 0 0
0 0 3 3 3 3 3 2 2 3 3 3 3 3 0 0
0 0 3 3 3 3 3 3 3 3 3 3 3 3 0 0
0 0 4 4 4 4 4 3 3 3 3 3 3 3 0 0
0 0 4 3 3 3 4 3 3 3 3 3 3 3 0 0
1 1 4 3 5 3 4 3 3 3 3 3 3 3 1 1
1 1 4 14 14 14 4 3 3 3 3 3 3 3 1 1
0 0 3 3 3 3 3 3 3 3 3 3 3 3 0 0
0 0 3 3 3 3 3 3 3 3 3 3 3 3 0 0
0 0 3 3 3 3 3 3 3 3 3 3 13 3 0 0
0 0 4 4 4 4 4 4 4 3 3 4 4 4 0 0
0 0 4 4 4 4 4 4 4 3 3 4 4 4 0 0
0 0 0 0 0 0 0 1 1 0 0 0 0 0 0 0
0 0 0 0 0 0 0 1 1 0 0 0 0 0 0 0

0 0 0 0 0 0 0 0 0 0 0 0 0 0 0 0
0 0 0 0 0 0 0 0 0 0 0 0 0 0 0 0
0 0 3 3 3 3 3 2 2 3 3 3 3 3 0 0
0 0 3 3 3 3 3 2 2 3 3 3 3 3 0 0
0 0 3 3 3 3 3 3 3 3 3 3 3 3 0 0
0 0 3 3 3 3 3 3 3 3 3 3 3 3 0 0
0 0 3 3 3 3 3 3 3 3 3 3 3 3 0 0
1 1 4 4 4 4 3 3 3 3 3 3 3 3 0 0
1 1 4 4 4 4 3 3 3 3 3 3 3 3 0 0
0 0 3 3 3 14 3 3 3 3 3 3 3 3 0 0
0 0 3 3 3 14 3 3 3 3 3 3 3 3 0 0
0 0 3 3 3 14 3 3 13 3 3 3 3 3 0 0
0 0 4 4 4 4 4 4 4 4 4 4 3 3 0 0
0 0 4 4 4 4 4 4 4 4 4 4 3 3 0 0
0 0 0 0 0 0 0 1 1 0 0 0 0 0 0 0
0 0 0 0 0 0 0 1 1 0 0 0 0 0 0 0