0 0 0 0 0 0 0 1 1 0 0 0 0 0 0 0
0 0 0 0 0 0 0 1 1 0 0 0 0 0 0 0
0 0 3 3 4 17 17 17 4 4 4 3 3 3 0 0
0 0 3 3 4 3 3 3 3 8 4 3 3 3 0 0
0 0 3 3 4 3 3 3 4 4 4 3 3 3 0 0
0 0 3 3 4 3 3 3 3 3 3 3 3 3 0 0
0 0 3 3 4 3 3 3 3 3 3 3 3 3 0 0
1 1 3 3 4 3 3 3 3 3 3 20 2 2 0 0
1 1 3 3 3 3 3 3 3 3 3 3 2 2 0 0
0 0 3 3 3 3 3 3 3 3 3 4 4 4 0 0
0 0 3 3 3 3 3 5 3 3 3 4 4 4 0 0
0 0 3 25 3 3 3 3 3 4 4 4 4 4 0 0
0 0 3 3 3 3 3 3 3 4 4 4 4 4 0 0
0 0 4 4 4 4 4 4 4 4 4 4 4 4 0 0
0 0 0 0 0 0 0 0 0 0 0 0 0 0 0 0
0 0 0 0 0 0 0 0 0 0 0 0 0 0 0 0

0 0 0 0 0 0 0 0 0 0 0 0 0 0 0 0
0 0 0 0 0 0 0 0 0 0 0 0 0 0 0 0
0 0 4 4 4 4 9 9 9 9 9 9 9 4 0 0
0 0 4 3 3 3 3 3 3 3 3 3 3 4 0 0
0 0 3 3 3 3 3 3 3 3 3 3 3 4 0 0
0 0 3 3 3 3 3 3 3 3 3 3 3 4 0 0
0 0 3 3 3 3 3 3 4 3 3 3 3 4 0 0
0 0 2 2 3 3 3 3 3 3 3 3 3 3 1 1
0 0 2 2 3 3 3 3 3 3 3 3 3 3 1 1
0 0 4 16 16 16 16 3 3 3 3 3 3 3 0 0
0 0 4 3 3 3 3 3 3 3 3 3 3 3 0 0
0 0 4 3 3 3 3 3 8 3 3 3 3 4 0 0
0 0 4 3 5 3 3 2 2 3 3 3 3 3 0 0
0 0 4 3 3 3 3 2 2 3 3 3 3 3 0 0
0 0 0 0 0 0 0 0 0 0 0 0 0 0 0 0
0 0 0 0 0 0 0 0 0 0 0 0 0 0 0 0

0 0 0 0 0 0 0 1 1 0 0 0 0 0 0 0
0 0 0 0 0 0 0 1 1 0 0 0 0 0 0 0
0 0 4 3 3 3 4 4 4 3 3 3 3 3 0 0
0 0 4 3 3 3 4 4 4 3 3 3 3 3 0 0
0 0 4 3 3 3 18 12 3 3 3 3 3 3 0 0
0 0 4 3 5 3 18 3 3 3 3 3 3 3 0 0
0 0 4 3 3 3 18 3 3 3 3 3 3 3 0 0
0 0 4 9 9 9 4 4 4 3 3 3 2 2 0 0
0 0 4 4 4 4 4 4 4 3 3 3 2 2 0 0
0 0 4 4 4 3 3 3 3 3 3 3 3 3 0 0
0 0 4 4 4 3 3 3 3 3 3 3 3 3 0 0
0 0 4 4 4 3 3 3 3 4 4 4 4 4 0 0
0 0 4 4 4 3 3 2 2 17 3 11 4 4 0 0
0 0 4 4 4 3 3 2 2 4 4 4 4 4 0 0
0 0 0 0 0 0 0 0 0 0 0 0 0 0 0 0
0 0 0 0 0 0 0 0 0 0 0 0 0 0 0 0

0 0 0 0 0 0 0 0 0 0 0 0 0 0 0 0
0 0 0 0 0 0 0 0 0 0 0 0 0 0 0 0
0 0 3 3 3 3 3 2 2 3 3 3 4 4 0 0
0 0 3 3 3 3 3 2 2 20 3 3 4 4 0 0
0 0 3 3 3 3 3 3 3 3 3 3 4 4 0 0
0 0 3 3 3 3 3 3 3 3 3 3 4 4 0 0
0 0 3 3 3 3 3 3 3 4 4 4 4 4 0 0
1 1 3 3 3 3 3 3 3 4 4 4 4 4 0 0
1 1 3 3 3 3 3 3 3 4 4 4 4 4 0 0
0 0 4 3 3 3 3 3 3 4 4 4 4 4 0 0
0 0 4 3 5 3 4 4 4 4 4 4 4 4 0 0
0 0 4 3 3 3 4 4 4 4 4 4 4 4 0 0
0 0 4 9 9 9 4 4 4 4 4 4 4 4 0 0
0 0 4 4 4 4 4 4 4 4 4 4 4 4 0 0
0 0 0 0 0 0 0 0 0 0 0 0 0 0 0 0
0 0 0 0 0 0 0 0 0 0 0 0 0 0 0 0

0 0 0 0 0 0 0 0 0 0 0 0 0 0 0 0
0 0 0 0 0 0 0 0 0 0 0 0 0 0 0 0
0 0 4 4 4 4 4 2 2 3 3 3 3 3 0 0
0 0 4 3 3 3 12 2 2 3 3 3 3 3 0 0
0 0 4 3 7 3 3 3 3 3 3 3 3 3 0 0
0 0 4 3 3 3 3 3 3 3 3 3 3 3 0 0
0 0 4 4 4 4 4 4 4 3 3 3 5 20 0 0
1 1 4 4 4 4 4 4 4 3 3 3 2 2 0 0
1 1 3 3 3 3 3 3 3 3 3 3 2 2 0 0
0 0 3 3 3 3 3 3 3 3 3 3 4 4 0 0
0 0 3 3 3 3 3 3 3 3 3 3 4 4 0 0
0 0 3 3 3 3 3 3 3 3 3 3 4 4 0 0
0 0 3 3 3 3 3 3 3 3 3 3 4 4 0 0
0 0 4 4 4 4 4 4 4 4 4 4 4 4 0 0
0 0 0 0 0 0 0 0 0 0 0 0 0 0 0 0
0 0 0 0 0 0 0 0 0 0 0 0 0 0 0 0

0 0 0 0 0 0 0 1 1 0 0 0 0 0 0 0
0 0 0 0 0 0 0 1 1 0 0 0 0 0 0 0
0 0 4 4 4 4 4 16 16 16 4 4 4 4 0 0
0 0 4 3 3 3 3 3 3 3 3 3 3 4 0 0
0 0 4 3 3 3 3 3 3 3 3 3 3 4 0 0
0 0 4 16 16 3 16 16 16 4 16 16 16 4 0 0
0 0 16 3 3 9 3 3 3 16 3 3 3 4 0 0
1 1 16 3 3 9 3 11 3 16 3 3 3 16 1 1
1 1 16 16 16 3 4 4 4 3 16 16 16 16 1 1
0 0 4 3 3 16 3 3 3 16 3 3 3 16 0 0
0 0 4 3 3 16 3 3 3 16 3 3 3 4 0 0
0 0 4 3 3 16 3 3 3 16 3 3 3 4 0 0
0 0 4 3 3 16 3 3 3 16 3 3 3 4 0 0
0 0 4 4 4 4 3 3 3 4 4 4 4 4 0 0
0 0 0 0 0 0 0 1 1 0 0 0 0 0 0 0
0 0 0 0 0 0 0 1 1 0 0 0 0 0 0 0