0 0 0 0 0 0 0 0 0 0 0 0 0 0 0 0
0 0 0 0 0 0 0 0 0 0 0 0 0 0 0 0
0 0 4 4 4 4 4 2 2 3 3 4 4 4 0 0
0 0 4 4 4 4 4 2 2 3 3 4 4 4 0 0
0 0 4 4 4 4 4 3 3 3 3 4 4 4 0 0
0 0 3 3 3 3 3 3 3 3 3 3 3 3 0 0
0 0 3 3 3 3 3 3 3 3 3 3 3 3 0 0
0 0 2 2 25 3 3 3 3 3 3 3 2 2 0 0
0 0 2 2 3 3 3 3 3 3 3 3 2 2 0 0
0 0 4 4 4 4 4 3 3 3 3 3 6 3 0 0
0 0 4 4 4 4 4 3 3 3 3 3 3 3 0 0
0 0 4 4 4 4 4 3 3 3 5 3 3 3 0 0
0 0 4 4 4 4 4 2 2 3 3 3 3 3 0 0
0 0 4 4 4 4 4 2 2 4 4 4 4 4 0 0
0 0 0 0 0 0 0 0 0 0 0 0 0 0 0 0
0 0 0 0 0 0 0 0 0 0 0 0 0 0 0 0

0 0 0 0 0 0 0 1 1 0 0 0 0 0 0 0
0 0 0 0 0 0 0 1 1 0 0 0 0 0 0 0
0 0 4 4 4 3 3 3 3 4 4 4 4 4 0 0
0 0 4 4 4 3 3 5 3 4 4 4 4 4 0 0
0 0 4 4 4 3 3 3 3 4 4 4 4 4 0 0
0 0 4 4 4 3 3 3 3 3 3 3 3 4 0 0
0 0 4 4 4 3 3 3 3 3 3 3 3 4 0 0
0 0 2 2 4 3 3 3 3 3 3 3 3 4 0 0
0 0 2 2 4 3 3 3 6 3 3 3 3 4 0 0
0 0 4 4 4 4 3 3 3 3 3 3 3 4 0 0
0 0 4 4 4 4 4 3 3 3 3 3 3 4 0 0
0 0 4 4 4 4 4 4 3 3 3 3 3 4 0 0
0 0 4 4 4 4 4 4 4 3 3 3 3 4 0 0
0 0 4 4 4 4 4 4 4 4 3 3 3 4 0 0
0 0 0 0 0 0 0 1 1 0 0 0 0 0 0 0
0 0 0 0 0 0 0 1 1 0 0 0 0 0 0 0

0 0 0 0 0 0 0 0 0 0 0 0 0 0 0 0
0 0 0 0 0 0 0 0 0 0 0 0 0 0 0 0
0 0 4 4 4 4 4 9 9 9 9 4 4 4 0 0
0 0 3 3 3 3 3 3 3 3 3 9 4 4 0 0
0 0 3 3 5 3 3 3 3 3 3 9 4 4 0 0
0 0 3 3 3 3 3 3 3 3 3 9 4 4 0 0
0 0 4 4 4 4 4 16 16 16 16 4 4 4 0 0
1 1 3 3 3 3 3 3 3 3 3 3 3 3 1 1
1 1 3 3 3 3 3 3 3 3 3 3 3 3 1 1
0 0 3 3 3 3 3 3 3 3 3 3 3 3 0 0
0 0 3 3 3 3 3 3 3 10 3 3 3 3 0 0
0 0 3 3 3 3 3 3 3 3 3 3 3 3 0 0
0 0 3 3 3 3 3 3 3 3 3 3 3 3 0 0
0 0 3 3 3 3 3 3 3 10 3 3 3 3 0 0
0 0 0 0 0 0 0 1 1 0 0 0 0 0 0 0
0 0 0 0 0 0 0 1 1 0 0 0 0 0 0 0

0 0 0 0 0 0 0 0 0 0 0 0 0 0 0 0
0 0 0 0 0 0 0 0 0 0 0 0 0 0 0 0
0 0 4 3 3 3 3 2 2 3 3 3 3 4 0 0
0 0 4 3 3 3 3 2 2 3 3 3 3 4 0 0
0 0 4 3 3 3 3 3 3 3 3 3 3 4 0 0
0 0 4 3 3 21 3 3 3 3 3 3 3 4 0 0
0 0 4 3 3 3 3 3 3 3 3 3 3 4 0 0
0 0 4 3 4 4 4 4 4 3 3 3 3 4 1 1
0 0 4 3 4 4 4 4 4 3 3 3 3 4 1 1
0 0 4 3 4 4 4 4 3 3 3 3 3 4 0 0
0 0 4 3 4 3 3 3 3 3 3 3 3 4 0 0
0 0 4 3 4 5 3 14 3 3 3 3 3 4 0 0
0 0 4 13 4 3 3 3 3 3 3 3 3 4 0 0
0 0 4 9 4 4 4 4 4 3 3 3 3 4 0 0
0 0 0 0 0 0 0 1 1 0 0 0 0 0 0 0
0 0 0 0 0 0 0 1 1 0 0 0 0 0 0 0

0 0 0 0 0 0 0 0 0 0 0 0 0 0 0 0
0 0 0 0 0 0 0 0 0 0 0 0 0 0 0 0
0 0 4 4 4 4 4 4 4 4 4 4 4 4 0 0
0 0 13 3 18 3 3 3 3 3 3 3 3 4 0 0
0 0 3 3 3 3 3 8 3 13 3 5 3 4 0 0
0 0 3 3 3 3 3 3 3 3 3 3 3 4 0 0
0 0 4 4 4 4 3 3 3 4 4 4 4 4 0 0
0 0 2 2 18 3 3 3 3 3 3 3 2 2 0 0
0 0 2 2 3 3 3 3 3 3 3 3 2 2 0 0
0 0 3 3 3 3 3 3 3 3 3 3 3 3 0 0
0 0 3 3 3 3 3 3 3 3 3 3 3 4 0 0
0 0 21 3 4 3 3 3 3 3 3 3 3 4 0 0
0 0 3 3 4 3 3 3 3 3 3 3 3 4 0 0
0 0 3 3 4 3 3 3 3 3 3 3 3 4 0 0
0 0 0 0 0 0 0 0 0 0 0 0 0 0 0 0
0 0 0 0 0 0 0 0 0 0 0 0 0 0 0 0

0 0 0 0 0 0 0 1 1 0 0 0 0 0 0 0
0 0 0 0 0 0 0 1 1 0 0 0 0 0 0 0
0 0 4 4 4 3 3 3 4 4 4 4 4 4 0 0
0 0 3 3 3 3 3 3 4 4 4 4 4 4 0 0
0 0 3 3 23 3 3 3 4 4 4 4 4 4 0 0
0 0 3 3 3 3 3 3 3 3 3 3 3 3 0 0
0 0 4 4 4 3 3 3 3 3 3 3 3 3 0 0
0 0 2 2 4 3 3 3 3 3 3 3 23 3 1 1
0 0 2 2 4 3 11 3 4 4 4 4 3 3 1 1
0 0 4 4 4 3 3 3 3 3 3 3 4 4 0 0
0 0 3 3 3 3 3 3 3 3 3 3 3 3 0 0
0 0 3 23 3 3 3 3 3 5 3 3 3 12 0 0
0 0 3 3 4 3 3 3 3 3 3 3 3 3 0 0
0 0 4 4 4 9 9 9 4 4 4 4 4 4 0 0
0 0 0 0 0 0 0 0 0 0 0 0 0 0 0 0
0 0 0 0 0 0 0 0 0 0 0 0 0 0 0 0

0 0 0 0 0 0 0 1 1 0 0 0 0 0 0 0
0 0 0 0 0 0 0 1 1 0 0 0 0 0 0 0
0 0 4 4 4 4 4 4 4 4 4 4 4 4 0 0
0 0 4 4 4 4 3 4 4 4 4 4 4 4 0 0
0 0 4 4 4 4 8 4 9 9 9 4 4 4 0 0
0 0 4 4 4 4 3 4 3 3 3 4 4 4 0 0
0 0 4 4 4 4 3 4 3 3 3 4 21 4 0 0
1 1 3 3 3 3 3 4 3 7 3 4 2 2 0 0
1 1 3 3 3 3 3 4 3 3 3 4 2 2 0 0
0 0 3 3 3 3 3 4 3 3 3 4 3 3 0 0
0 0 3 3 3 3 3 3 3 3 3 3 3 3 0 0
0 0 3 3 3 3 3 3 3 3 3 23 3 3 0 0
0 0 3 3 3 3 3 2 2 3 3 3 3 3 0 0
0 0 3 3 3 3 3 2 2 3 3 4 3 3 0 0
0 0 0 0 0 0 0 0 0 0 0 0 0 0 0 0
0 0 0 0 0 0 0 0 0 0 0 0 0 0 0 0

