0 0 0 0 0 0 0 0 0 0 0 0 0 0 0 0
0 0 0 0 0 0 0 0 0 0 0 0 0 0 0 0
0 0 3 3 3 3 3 2 2 3 3 3 3 3 0 0
0 0 3 25 3 3 3 2 2 3 3 3 3 3 0 0
0 0 3 3 3 3 3 3 3 3 3 3 3 3 0 0
0 0 4 4 4 4 4 4 3 3 3 3 3 3 0 0
0 0 3 3 3 3 3 3 3 3 3 3 3 3 0 0
0 0 3 3 3 3 3 3 3 3 3 20 2 2 0 0
0 0 11 3 3 3 3 3 3 3 3 3 2 2 0 0
0 0 3 3 3 3 3 3 3 3 3 4 4 4 0 0
0 0 3 3 3 3 3 3 3 3 3 12 3 3 0 0
0 0 10 10 3 3 10 10 3 3 3 3 3 5 0 0
0 0 3 3 3 3 3 3 3 3 3 3 3 3 0 0
0 0 9 9 9 9 9 9 9 9 4 4 4 4 0 0
0 0 0 0 0 0 0 0 0 0 0 0 0 0 0 0
0 0 0 0 0 0 0 0 0 0 0 0 0 0 0 0

0 0 0 0 0 0 0 1 1 0 0 0 0 0 0 0
0 0 0 0 0 0 0 1 1 0 0 0 0 0 0 0
0 0 3 3 3 3 3 3 3 3 3 4 4 4 0 0
0 0 3 3 3 3 3 10 10 3 3 3 3 3 0 0
0 0 4 10 10 3 3 3 3 3 3 3 3 3 0 0
0 0 8 3 3 3 3 3 3 3 3 3 3 3 0 0
0 0 3 3 3 3 3 3 3 3 3 3 3 3 0 0
0 0 3 3 3 3 3 3 3 3 3 3 3 3 1 1
0 0 16 16 3 3 3 3 3 3 3 3 3 3 1 1
0 0 3 3 3 3 10 10 3 3 3 3 3 5 0 0
0 0 3 3 3 3 3 3 3 10 10 3 3 3 0 0
0 0 3 3 3 3 3 3 3 3 3 3 3 10 0 0
0 0 3 3 3 3 3 3 3 3 3 3 3 3 0 0
0 0 3 3 3 3 3 3 3 3 3 3 3 3 0 0
0 0 0 0 0 0 0 0 0 0 0 0 0 0 0 0
0 0 0 0 0 0 0 0 0 0 0 0 0 0 0 0

0 0 0 0 0 0 0 1 1 0 0 0 0 0 0 0
0 0 0 0 0 0 0 1 1 0 0 0 0 0 0 0
0 0 4 4 4 4 3 3 3 3 3 3 3 4 0 0
0 0 4 4 4 4 3 3 3 3 3 3 3 4 0 0
0 0 4 4 4 4 4 4 4 4 4 3 3 4 0 0
0 0 4 4 4 4 9 9 9 4 4 3 3 4 0 0
0 0 4 4 4 4 3 3 3 4 4 3 3 4 0 0
0 0 4 4 4 4 3 3 3 4 4 3 3 4 0 0
0 0 4 4 4 4 3 3 3 3 3 3 3 4 0 0
0 0 4 4 4 4 3 3 3 20 3 3 3 4 0 0
0 0 4 4 4 4 3 3 3 5 3 3 3 4 0 0
0 0 4 4 4 4 3 3 3 3 3 9 9 4 0 0
0 0 4 4 4 4 3 2 2 4 4 4 4 4 0 0
0 0 9 9 9 9 3 2 2 9 9 9 9 9 0 0
0 0 0 0 0 0 0 0 0 0 0 0 0 0 0 0
0 0 0 0 0 0 0 0 0 0 0 0 0 0 0 0

0 0 0 0 0 0 0 0 0 0 0 0 0 0 0 0
0 0 0 0 0 0 0 0 0 0 0 0 0 0 0 0
0 0 4 3 3 3 3 2 2 3 3 3 3 4 0 0
0 0 4 10 10 3 3 2 2 3 3 3 3 4 0 0
0 0 4 3 3 3 3 3 3 3 3 3 3 4 0 0
0 0 4 3 3 3 3 10 10 3 3 3 3 4 0 0
0 0 4 9 9 3 3 3 3 3 3 3 10 4 0 0
0 0 4 3 3 9 9 9 9 3 3 3 3 4 0 0
0 0 4 3 3 3 3 3 3 3 3 3 3 4 0 0
0 0 4 3 3 3 3 3 3 3 3 3 3 4 0 0
0 0 4 5 20 3 3 3 3 3 3 3 3 4 0 0
0 0 4 3 3 3 3 3 3 3 3 3 3 4 0 0
0 0 4 4 4 3 10 2 2 10 3 3 3 4 0 0
0 0 4 4 4 3 3 2 2 3 3 3 9 4 0 0
0 0 0 0 0 0 0 0 0 0 0 0 0 0 0 0
0 0 0 0 0 0 0 0 0 0 0 0 0 0 0 0

0 0 0 0 0 0 0 1 1 0 0 0 0 0 0 0
0 0 0 0 0 0 0 1 1 0 0 0 0 0 0 0
0 0 4 10 10 10 10 10 10 10 10 10 10 4 0 0
0 0 10 3 3 3 3 3 3 3 3 3 3 10 0 0
0 0 10 3 3 3 3 7 3 3 3 3 9 10 0 0
0 0 10 3 3 3 3 3 3 3 3 3 9 10 0 0
0 0 10 3 9 3 3 3 3 3 3 3 3 10 0 0
1 1 10 3 3 3 3 3 3 3 3 3 3 10 1 1
1 1 10 3 3 9 3 3 3 9 3 3 3 10 1 1
0 0 10 3 3 3 3 9 3 3 3 3 3 10 0 0
0 0 10 3 3 3 3 3 3 9 3 3 3 10 0 0
0 0 10 3 3 9 3 3 3 3 3 3 3 10 0 0
0 0 10 9 3 3 3 9 3 9 9 3 3 10 0 0
0 0 4 10 10 10 10 10 10 10 10 10 10 4 0 0
0 0 0 0 0 0 0 1 1 0 0 0 0 0 0 0
0 0 0 0 0 0 0 1 1 0 0 0 0 0 0 0