0 0 0 0 0 0 0 1 1 0 0 0 0 0 0 0
0 0 0 0 0 0 0 1 1 0 0 0 0 0 0 0
0 0 3 3 3 3 3 3 3 3 3 3 3 3 0 0
0 0 3 3 3 3 3 3 3 3 3 3 3 3 0 0
0 0 3 3 3 3 3 3 3 3 3 3 3 3 0 0
0 0 3 3 3 3 3 3 3 3 3 3 3 3 0 0
0 0 3 3 3 3 3 3 3 3 3 3 3 3 0 0
1 1 3 3 3 3 3 3 3 3 3 3 3 3 1 1
1 1 3 3 3 3 3 3 3 3 3 3 3 3 1 1
0 0 3 3 3 3 3 3 3 3 3 3 3 3 0 0
0 0 3 3 3 3 3 5 3 3 6 3 3 3 0 0
0 0 3 3 3 3 3 3 3 3 3 3 3 3 0 0
0 0 4 4 4 4 4 4 4 4 4 4 4 4 0 0
0 0 4 4 4 4 4 4 4 4 4 4 4 4 0 0
0 0 0 0 0 0 0 1 1 0 0 0 0 0 0 0
0 0 0 0 0 0 0 1 1 0 0 0 0 0 0 0

0 0 0 0 0 0 0 1 1 0 0 0 0 0 0 0
0 0 0 0 0 0 0 1 1 0 0 0 0 0 0 0
0 0 4 4 3 3 3 3 3 4 4 4 4 4 0 0
0 0 4 4 3 3 3 3 3 3 4 4 4 4 0 0
0 0 4 4 3 3 3 3 3 3 3 4 4 4 0 0
0 0 4 4 3 3 3 3 3 3 3 3 4 4 0 0
0 0 4 4 3 3 3 3 3 3 3 3 4 4 0 0
1 1 4 4 3 3 3 3 3 3 3 3 4 4 1 1
1 1 4 4 3 3 3 6 3 3 3 3 4 4 1 1
0 0 4 4 3 3 3 3 3 3 3 3 3 3 0 0
0 0 4 4 3 3 3 3 3 3 5 3 3 3 0 0
0 0 4 4 3 3 3 3 3 3 3 3 3 3 0 0
0 0 4 4 4 4 4 4 4 4 4 4 4 4 0 0
0 0 4 4 4 4 4 4 4 4 4 4 4 4 0 0
0 0 0 0 0 0 0 1 1 0 0 0 0 0 0 0
0 0 0 0 0 0 0 1 1 0 0 0 0 0 0 0

0 0 0 0 0 0 0 0 0 0 0 0 0 0 0 0
0 0 0 0 0 0 0 0 0 0 0 0 0 0 0 0
0 0 3 3 3 3 3 2 2 3 3 3 3 3 0 0
0 0 3 3 3 3 3 2 2 3 3 3 3 3 0 0
0 0 3 3 3 3 3 3 3 3 3 5 3 3 0 0
0 0 3 3 3 3 3 3 3 3 3 3 3 3 0 0
0 0 3 3 3 3 3 3 3 3 3 3 3 3 0 0
0 0 2 2 3 3 3 3 4 4 4 4 4 4 0 0
0 0 2 2 3 3 3 3 4 4 4 4 4 4 0 0
0 0 3 3 3 3 3 3 4 4 4 4 4 4 0 0
0 0 3 3 3 3 3 3 4 4 4 4 4 4 0 0
0 0 3 3 3 3 3 3 4 4 4 4 4 4 0 0
0 0 4 4 4 4 4 4 4 4 4 4 4 4 0 0
0 0 4 4 4 4 4 4 4 4 4 4 4 4 0 0
0 0 0 0 0 0 0 0 0 0 0 0 0 0 0 0
0 0 0 0 0 0 0 0 0 0 0 0 0 0 0 0

0 0 0 0 0 0 0 0 0 0 0 0 0 0 0 0
0 0 0 0 0 0 0 0 0 0 0 0 0 0 0 0
0 0 4 4 4 4 4 4 4 4 4 4 4 4 0 0
0 0 4 4 4 4 4 4 4 4 4 4 4 4 0 0
0 0 3 3 3 3 4 4 4 4 4 4 4 4 0 0
0 0 3 3 5 3 4 4 4 4 4 4 4 4 0 0
0 0 3 3 3 3 4 4 4 4 4 4 4 4 0 0
0 0 2 2 3 3 4 4 4 4 4 4 4 4 0 0
0 0 2 2 4 4 4 4 4 4 4 4 4 4 0 0
0 0 4 4 4 4 4 4 4 4 4 4 4 4 0 0
0 0 4 4 4 4 4 4 4 4 4 4 4 4 0 0
0 0 4 4 4 4 4 4 4 4 4 4 4 4 0 0
0 0 4 4 4 4 4 4 4 4 4 4 4 4 0 0
0 0 4 4 4 4 4 4 4 4 4 4 4 4 0 0
0 0 0 0 0 0 0 0 0 0 0 0 0 0 0 0
0 0 0 0 0 0 0 0 0 0 0 0 0 0 0 0

0 0 0 0 0 0 0 0 0 0 0 0 0 0 0 0
0 0 0 0 0 0 0 0 0 0 0 0 0 0 0 0
0 0 3 3 4 3 4 2 2 3 3 3 3 3 0 0
0 0 3 9 4 3 4 2 2 3 3 3 3 3 0 0
0 0 3 9 4 3 4 9 9 9 9 9 9 9 0 0
0 0 3 9 4 7 4 4 4 4 4 4 4 4 0 0
0 0 3 9 4 3 4 4 4 4 4 4 4 4 0 0
0 0 2 2 4 3 4 4 4 4 4 4 2 2 0 0
0 0 2 2 4 3 3 3 3 3 3 3 2 2 0 0
0 0 3 9 4 3 3 3 3 3 3 3 3 3 0 0
0 0 3 9 4 3 3 3 3 3 3 3 3 3 0 0
0 0 3 9 4 3 3 3 3 3 3 3 3 3 0 0
0 0 3 9 4 4 4 2 2 4 4 4 4 4 0 0
0 0 3 3 9 9 9 2 2 9 9 9 9 9 0 0
0 0 0 0 0 0 0 0 0 0 0 0 0 0 0 0
0 0 0 0 0 0 0 0 0 0 0 0 0 0 0 0