0 0 0 0 0 0 0 0 0 0 0 0 0 0 0 0
0 0 0 0 0 0 0 0 0 0 0 0 0 0 0 0
0 0 3 3 3 3 3 2 2 3 3 3 3 3 0 0
0 0 3 3 3 3 3 2 2 3 3 3 3 3 0 0
0 0 3 3 3 3 3 3 3 3 3 3 3 3 0 0
0 0 3 3 3 3 3 3 3 3 3 3 3 3 0 0
0 0 3 3 3 3 3 3 3 3 3 3 3 3 0 0
0 0 2 2 3 3 3 3 3 3 4 4 4 4 1 1
0 0 2 2 3 3 3 3 3 3 12 3 3 4 1 1
0 0 3 3 3 3 5 3 3 3 3 3 8 4 0 0
0 0 3 3 3 3 3 3 3 3 3 3 3 4 0 0
0 0 3 25 20 3 3 3 3 4 4 4 4 4 0 0
0 0 3 3 3 3 3 3 4 4 4 4 4 4 0 0
0 0 4 4 4 4 4 4 4 4 4 4 4 4 0 0
0 0 0 0 0 0 0 0 0 0 0 0 0 0 0 0
0 0 0 0 0 0 0 0 0 0 0 0 0 0 0 0

0 0 0 0 0 0 0 1 1 0 0 0 0 0 0 0
0 0 0 0 0 0 0 1 1 0 0 0 0 0 0 0
0 0 4 4 4 4 4 4 4 4 3 3 3 4 0 0
0 0 4 3 3 3 3 3 16 3 3 3 3 4 0 0
0 0 4 3 5 3 3 3 16 3 3 3 3 4 0 0
0 0 4 4 4 4 4 4 4 3 3 3 3 4 0 0
0 0 3 3 3 3 3 3 3 3 3 3 3 4 0 0
1 1 3 3 3 3 3 3 3 3 3 3 3 4 1 1
1 1 3 3 3 3 11 3 3 3 3 3 3 4 1 1
0 0 4 3 3 3 3 20 8 3 3 3 3 4 0 0
0 0 4 3 3 3 3 3 3 3 3 3 3 3 0 0
0 0 4 3 3 3 3 3 3 3 3 3 3 3 0 0
0 0 4 3 3 3 3 3 3 3 3 3 3 3 0 0
0 0 4 3 3 3 4 4 4 4 4 4 4 4 0 0
0 0 0 0 0 0 0 1 1 0 0 0 0 0 0 0
0 0 0 0 0 0 0 1 1 0 0 0 0 0 0 0

0 0 0 0 0 0 0 1 1 0 0 0 0 0 0 0
0 0 0 0 0 0 0 1 1 0 0 0 0 0 0 0
0 0 3 3 3 3 3 3 3 3 3 3 3 3 0 0
0 0 3 3 3 3 3 3 3 3 3 3 3 3 0 0
0 0 3 3 3 3 3 3 3 3 3 3 3 3 0 0
0 0 3 3 3 3 3 3 3 3 3 3 3 3 0 0
0 0 3 3 3 3 3 3 3 3 3 3 3 5 0 0
0 0 2 2 3 3 3 3 3 3 3 3 3 3 0 0
0 0 2 2 3 3 3 3 3 3 3 3 3 3 0 0
0 0 4 4 4 3 3 3 3 3 3 3 3 4 0 0
0 0 4 4 4 4 3 3 3 3 3 3 3 4 0 0
0 0 4 4 4 4 4 3 3 3 3 3 3 4 0 0
0 0 4 4 4 4 4 4 3 3 3 3 3 4 0 0
0 0 4 4 4 4 4 4 4 4 4 4 4 4 0 0
0 0 0 0 0 0 0 0 0 0 0 0 0 0 0 0
0 0 0 0 0 0 0 0 0 0 0 0 0 0 0 0

0 0 0 0 0 0 0 0 0 0 0 0 0 0 0 0
0 0 0 0 0 0 0 0 0 0 0 0 0 0 0 0
0 0 4 4 4 4 4 4 4 4 4 4 4 4 0 0
0 0 4 3 3 3 3 3 3 3 3 3 18 3 0 0
0 0 4 3 3 3 5 3 3 3 3 3 18 3 0 0
0 0 4 3 3 3 3 3 3 3 3 3 18 3 0 0
0 0 4 3 3 3 3 3 3 3 3 4 4 4 0 0
0 0 4 3 3 3 3 3 3 3 3 4 2 2 0 0
0 0 4 3 3 3 3 3 3 3 3 4 2 2 0 0
0 0 4 3 5 3 3 3 3 4 4 4 4 4 0 0
0 0 4 3 3 3 3 3 3 4 3 3 3 3 0 0
0 0 4 3 20 3 3 3 3 4 3 7 3 12 0 0
0 0 4 3 3 3 3 2 2 4 3 3 3 3 0 0
0 0 4 3 3 3 3 2 2 4 4 4 4 4 0 0
0 0 0 0 0 0 0 0 0 0 0 0 0 0 0 0
0 0 0 0 0 0 0 0 0 0 0 0 0 0 0 0

0 0 0 0 0 0 0 0 0 0 0 0 0 0 0 0
0 0 0 0 0 0 0 0 0 0 0 0 0 0 0 0
0 0 4 4 4 4 4 4 4 4 4 4 4 4 0 0
0 0 4 4 4 3 11 3 18 3 3 3 3 4 0 0
0 0 4 4 4 3 3 3 18 3 3 3 3 4 0 0
0 0 4 4 4 4 4 4 4 3 3 3 3 4 0 0
0 0 3 3 3 3 3 3 3 3 3 3 3 4 0 0
1 1 3 3 3 3 3 3 3 3 3 3 3 4 1 1
1 1 4 4 4 4 4 4 3 3 3 3 3 4 1 1
0 0 4 4 4 4 4 4 3 3 3 3 3 3 0 0
0 0 4 4 4 4 4 4 3 3 3 3 3 3 0 0
0 0 4 4 4 4 4 4 3 3 3 3 3 3 0 0
0 0 4 4 4 4 4 4 3 3 3 3 3 4 0 0
0 0 4 4 4 4 4 4 3 3 3 3 3 4 0 0
0 0 0 0 0 0 0 1 1 0 0 0 0 0 0 0
0 0 0 0 0 0 0 1 1 0 0 0 0 0 0 0