0 0 0 0 0 0 0 0 0 0 0 0 0 0 0 0
0 0 0 0 0 0 0 0 0 0 0 0 0 0 0 0
0 0 3 3 3 3 3 3 3 3 3 3 3 3 0 0
0 0 3 3 3 3 3 3 3 3 3 3 3 3 0 0
0 0 3 3 3 3 3 3 3 3 3 3 3 3 0 0
0 0 3 3 3 3 3 3 3 3 3 3 3 3 0 0
0 0 3 3 3 3 3 3 3 3 3 3 3 3 0 0
0 0 3 3 3 3 3 3 3 3 3 3 3 3 1 1
0 0 3 3 3 3 3 3 3 3 3 5 3 3 1 1
0 0 3 3 3 3 3 3 3 3 3 3 26 3 0 0
0 0 3 25 3 3 3 3 3 3 4 4 4 4 0 0
0 0 3 3 3 4 4 4 3 3 4 4 4 4 0 0
0 0 4 4 4 4 4 4 4 4 4 4 4 4 0 0
0 0 4 4 4 4 4 4 4 4 4 4 4 4 0 0
0 0 0 0 0 0 0 0 0 0 0 0 0 0 0 0
0 0 0 0 0 0 0 0 0 0 0 0 0 0 0 0

0 0 0 0 0 0 0 0 0 0 0 0 0 0 0 0
0 0 0 0 0 0 0 0 0 0 0 0 0 0 0 0
0 0 3 3 3 3 3 3 3 3 3 3 3 3 0 0
0 0 3 3 3 3 3 3 3 3 3 3 3 3 0 0
0 0 3 3 3 3 3 3 3 3 3 3 3 3 0 0
0 0 3 3 3 3 3 3 3 3 3 5 3 3 0 0
0 0 3 3 3 3 3 3 3 3 3 27 3 3 0 0
0 0 2 2 3 3 3 3 3 3 4 4 4 4 1 1
0 0 2 2 3 3 3 3 3 3 4 4 4 4 1 1
0 0 3 4 4 4 3 3 3 4 4 4 4 4 0 0
0 0 4 4 4 4 3 3 3 3 3 3 3 3 0 0
0 0 4 4 4 4 4 3 3 3 3 3 3 3 0 0
0 0 4 4 4 4 4 4 3 3 3 3 3 3 0 0
0 0 4 4 4 4 4 4 4 4 4 4 4 4 0 0
0 0 0 0 0 0 0 0 0 0 0 0 0 0 0 0
0 0 0 0 0 0 0 0 0 0 0 0 0 0 0 0

0 0 0 0 0 0 0 0 0 0 0 0 0 0 0 0
0 0 0 0 0 0 0 0 0 0 0 0 0 0 0 0
0 0 4 3 3 3 3 2 2 3 3 3 3 4 0 0
0 0 4 3 3 3 3 2 2 3 3 3 3 4 0 0
0 0 4 3 3 3 3 4 4 28 3 3 3 4 0 0
0 0 4 3 3 3 3 4 4 3 7 3 3 4 0 0
0 0 4 3 3 3 3 4 4 3 3 3 3 4 0 0
0 0 4 4 4 4 4 4 4 4 4 4 4 4 0 0
0 0 4 4 4 4 4 4 4 4 4 4 4 4 0 0
0 0 4 3 3 3 3 4 4 3 3 3 3 4 0 0
0 0 4 3 3 3 3 4 4 3 3 3 3 4 0 0
0 0 4 3 3 3 3 4 4 3 3 3 3 4 0 0
0 0 4 3 3 3 3 2 2 3 3 3 3 4 0 0
0 0 4 3 3 3 3 2 2 3 3 3 3 4 0 0
0 0 0 0 0 0 0 0 0 0 0 0 0 0 0 0
0 0 0 0 0 0 0 0 0 0 0 0 0 0 0 0

