0 0 0 0 0 0 0 0 0 0 0 0 0 0 0 0
0 0 0 0 0 0 0 0 0 0 0 0 0 0 0 0
0 0 3 3 3 3 3 3 3 3 3 3 3 3 0 0
0 0 3 3 3 3 3 3 3 3 3 3 3 3 0 0
0 0 3 3 3 3 3 3 3 3 3 3 3 3 0 0
0 0 3 3 3 3 3 3 3 3 3 3 3 3 0 0
0 0 3 3 3 3 3 3 3 3 3 3 3 3 0 0
0 0 2 2 3 3 3 3 3 4 3 3 2 2 0 0
0 0 2 2 3 3 3 5 3 4 3 3 2 2 0 0
0 0 3 3 3 3 18 18 18 3 3 4 4 3 0 0
0 0 3 3 3 3 3 3 3 3 3 4 4 3 0 0
0 0 3 3 3 3 3 3 3 3 4 4 4 4 0 0
0 0 3 3 3 3 3 3 3 3 4 4 4 4 0 0
0 0 4 4 4 4 4 4 4 4 4 4 4 4 0 0
0 0 0 0 0 0 0 0 0 0 0 0 0 0 0 0
0 0 0 0 0 0 0 0 0 0 0 0 0 0 0 0

0 0 0 0 0 0 0 1 1 0 0 0 0 0 0 0
0 0 0 0 0 0 0 1 1 0 0 0 0 0 0 0
0 0 3 3 3 3 4 3 3 3 4 3 3 3 0 0
0 0 3 3 3 3 4 3 3 3 4 3 3 3 0 0
0 0 3 3 3 3 4 3 3 3 4 3 3 3 0 0
0 0 3 3 3 3 4 3 3 3 4 3 3 3 0 0
0 0 3 3 3 3 4 3 3 3 4 3 3 3 0 0
1 1 3 3 3 3 4 3 3 3 4 3 2 2 0 0
1 1 3 3 3 3 4 3 3 3 4 3 2 2 0 0
0 0 3 3 3 3 16 3 3 3 18 3 3 3 0 0
0 0 3 3 3 3 16 3 3 3 18 3 5 3 0 0
0 0 3 3 3 3 16 3 3 3 18 3 3 3 0 0
0 0 3 3 3 3 16 3 3 3 18 3 3 3 0 0
0 0 4 4 4 4 4 4 4 4 4 4 4 4 0 0
0 0 0 0 0 0 0 0 0 0 0 0 0 0 0 0
0 0 0 0 0 0 0 0 0 0 0 0 0 0 0 0

0 0 0 0 0 0 0 0 0 0 0 0 0 0 0 0
0 0 0 0 0 0 0 0 0 0 0 0 0 0 0 0
0 0 3 3 3 3 3 3 3 3 3 3 3 3 0 0
0 0 3 3 3 3 3 3 3 3 3 3 3 3 0 0
0 0 3 3 3 3 3 3 3 3 3 3 3 3 0 0
0 0 3 3 3 3 3 3 3 3 3 3 3 3 0 0
0 0 4 4 4 4 3 3 3 3 3 3 3 3 0 0
1 1 4 3 3 4 3 3 3 3 3 3 2 2 0 0
1 1 4 3 8 4 3 3 3 3 3 5 2 2 0 0
0 0 4 18 18 4 3 3 3 3 3 3 3 3 0 0
0 0 3 3 3 3 3 3 3 3 3 3 3 3 0 0
0 0 3 3 3 3 3 3 3 3 3 4 4 4 0 0
0 0 3 3 3 3 3 3 3 3 3 4 4 4 0 0
0 0 4 4 4 4 4 4 3 3 3 4 4 4 0 0
0 0 0 0 0 0 0 1 1 0 0 0 0 0 0 0
0 0 0 0 0 0 0 1 1 0 0 0 0 0 0 0

0 0 0 0 0 0 0 1 1 0 0 0 0 0 0 0
0 0 0 0 0 0 0 1 1 0 0 0 0 0 0 0
0 0 4 4 4 4 3 3 3 3 18 3 3 3 0 0
0 0 4 4 4 4 3 3 3 3 18 3 8 3 0 0
0 0 4 4 4 4 3 3 3 3 18 3 3 3 0 0
0 0 4 4 4 4 3 3 3 3 3 18 18 18 0 0
0 0 4 3 3 4 3 3 3 3 3 3 3 3 0 0
1 1 4 3 3 4 3 3 3 3 3 3 3 3 1 1
1 1 4 3 3 3 3 3 3 3 3 3 3 3 1 1
0 0 4 3 3 3 3 3 3 3 3 3 3 3 0 0
0 0 4 3 3 3 3 3 4 4 4 4 4 4 0 0
0 0 4 3 3 3 3 3 3 5 4 4 4 4 0 0
0 0 4 3 3 3 3 3 3 3 4 4 4 4 0 0
0 0 4 4 4 4 4 4 4 4 4 4 4 4 0 0
0 0 0 0 0 0 0 0 0 0 0 0 0 0 0 0
0 0 0 0 0 0 0 0 0 0 0 0 0 0 0 0