0 0 0 0 0 0 0 0 0 0 0 0 0 0 0 0
0 0 0 0 0 0 0 0 0 0 0 0 0 0 0 0
0 0 3 3 3 3 3 3 3 3 3 3 3 3 0 0
0 0 3 3 3 3 3 3 3 3 3 3 3 3 0 0
0 0 3 3 3 3 3 3 3 3 3 3 3 3 0 0
0 0 3 3 3 3 3 3 3 3 3 3 3 3 0 0
0 0 3 3 3 3 3 3 3 3 3 3 3 3 0 0
1 1 0 0 3 3 3 3 3 3 3 20 2 2 0 0
1 1 0 0 3 5 3 3 3 3 3 3 2 2 0 0
0 0 3 3 17 17 17 3 3 3 3 3 16 16 0 0
0 0 3 3 3 3 3 3 3 3 3 3 3 3 0 0
0 0 3 25 3 3 3 3 3 3 16 16 3 3 0 0
0 0 3 3 3 3 3 3 3 33 3 3 3 3 0 0
0 0 4 4 4 4 4 4 4 4 4 4 4 4 0 0
0 0 0 0 0 0 0 0 0 0 0 0 0 0 0 0
0 0 0 0 0 0 0 0 0 0 0 0 0 0 0 0

0 0 0 0 0 0 0 1 1 0 0 0 0 0 0 0
0 0 0 0 0 0 0 1 1 0 0 0 0 0 0 0
0 0 4 4 4 4 4 3 3 3 4 4 4 4 0 0
0 0 4 4 4 4 4 3 3 3 4 4 4 4 0 0
0 0 4 4 4 4 4 3 3 3 4 4 4 4 0 0
0 0 4 4 4 4 4 3 3 3 4 4 4 4 0 0
0 0 4 4 4 4 4 3 3 3 4 4 4 4 0 0
1 1 4 4 4 4 4 3 3 3 4 4 2 2 0 0
1 1 4 4 4 4 4 3 3 3 4 4 2 2 0 0
0 0 3 3 3 3 16 3 3 3 17 3 3 3 0 0
0 0 3 3 3 3 16 3 3 3 17 3 3 5 0 0
0 0 3 3 3 3 16 3 3 3 17 3 3 3 0 0
0 0 3 3 3 3 16 3 3 3 17 3 3 3 0 0
0 0 4 4 4 4 4 4 4 4 4 4 4 4 0 0
0 0 0 0 0 0 0 0 0 0 0 0 0 0 0 0
0 0 0 0 0 0 0 0 0 0 0 0 0 0 0 0

0 0 0 0 0 0 0 0 0 0 0 0 0 0 0 0
0 0 0 0 0 0 0 0 0 0 0 0 0 0 0 0
0 0 3 3 3 3 3 2 2 3 3 3 3 3 0 0
0 0 3 3 3 3 3 2 2 3 3 3 3 3 0 0
0 0 3 3 3 3 3 3 3 3 3 3 3 3 0 0
0 0 3 3 3 3 3 3 3 3 3 3 3 3 0 0
0 0 3 3 8 3 3 3 3 3 3 5 3 3 0 0
1 1 3 3 3 3 3 3 3 3 3 3 3 3 1 1
1 1 3 17 17 17 3 3 3 3 3 3 3 3 1 1
0 0 3 3 3 3 3 3 3 3 3 3 3 3 0 0
0 0 3 3 3 3 3 3 3 3 4 4 4 4 0 0
0 0 3 3 3 3 20 3 3 3 4 4 4 4 0 0
0 0 3 3 3 3 3 3 3 3 4 4 4 4 0 0
0 0 4 4 4 4 4 4 3 3 4 4 4 4 0 0
0 0 0 0 0 0 0 1 1 0 0 0 0 0 0 0
0 0 0 0 0 0 0 1 1 0 0 0 0 0 0 0

0 0 0 0 0 0 0 0 0 0 0 0 0 0 0 0
0 0 0 0 0 0 0 0 0 0 0 0 0 0 0 0
0 0 4 4 4 4 4 2 2 3 17 3 3 3 0 0
0 0 4 4 4 4 4 2 2 3 17 3 8 3 0 0
0 0 4 4 4 4 4 3 3 3 17 3 3 3 0 0
0 0 4 4 4 4 4 3 3 3 3 17 17 17 0 0
0 0 4 34 3 4 4 3 3 3 3 3 3 3 0 0
1 1 16 3 3 3 4 3 3 3 3 3 3 3 1 1
1 1 4 3 3 3 3 3 3 3 3 3 3 3 1 1
0 0 4 3 3 3 3 3 4 4 4 4 4 4 0 0
0 0 4 3 3 3 3 3 3 4 4 4 4 4 0 0
0 0 4 3 3 3 3 3 3 7 4 4 4 4 0 0
0 0 4 3 3 3 3 3 3 3 4 4 4 4 0 0
0 0 4 4 4 4 4 4 16 4 4 4 4 4 0 0
0 0 0 0 0 0 0 1 1 0 0 0 0 0 0 0
0 0 0 0 0 0 0 1 1 0 0 0 0 0 0 0